                                                       *|*    *|*   *|****            *|*                         *|*                  **|*                                                                                            *|*                                                                        *|*     *|*                                                        ***                        
                                                       *|*    *|*   *|**|*            *|*                         *|*            ***   *||*                                                  ***      ***                  ***         *|*      ***        ******                                                 *|*     *|*            *** ***           ***                       *|* ***             ***    
                                                       *|*    *|*   *|**|*           **|*                      ****|*            *|*   *||*                                                  *|*      *|*                  *|*         *|*      *|*        *|**|*                                                 *|*     *|****         *|* *|*           *|*          ***          *|* *|*             *|*    
                                                       *|*    *|*   *|*||*           *||*                      *|**|*            *|*   *||*                                                  *|*      *|*                  *|*         *|*      *|*        *|**|*                                                 *|*     *|**|*         *|* *|*           *|*          *|*          *|* *|*             *|*    
                                                        |      |    *|*||*           *||                       *|* |              |    *||                                                   *|*      *|*                  *|*         *|*      *|*        *|* |                                                  *|*     *|**|*         *|* *|*            |           *|*           |   |              *|*    
                                                        |      |     |*||*           *||                       *|* |              |     ||                                                   *|*       |                    |           |        |         *|* |                                                   |       |  |          *|*  |             |           *|*           |   |              *|*    
                              ***             - -   -- ---  ----   --|-||-       - -- |-  -  -- - ---   -      -| --- -- -   --   -  ---|-- - - ---   -       -     -  - -    -     --  -  -- |     - -|   --    --   ----  | --        | - -- --|-     - --|- - --   - - - --  --  -  -  --  ---- - -        -  --|  -   -|  |   -  -    |- -| -   --      -- -    -  - |       -    -   ---  - -        |  -  
                              *|*         - --E-S-- EE SES- EESS --EE-E||E--   - E-ES |E  E--ES-S-EES---E---- -S|-EES EE-E - EE  -E--EEE-SE E-E-EEE  -E  --  -E- - -E--E-S--- S--  -RE- E--ER-| -- -E-E- --ES-- -SE- -EEES----SE  ------- S-SS ES-E  ---E-EE|S S-ES --E-E E-EE -RS- S--E -SE--SSEE-E-E----- - E--ES-  E- -E-- --  E--S-- -|E-R--E---SS - - -EE S-- -E -E-|-- --- E ---E---EES--E-E-  -- --| -S  
                              *|*         E-SESESEE-SE-EEEE-ERES-ESSSES--SEE---E-SESE--S--EEESSSEERSSREEEEEEE-SE-SEES-SSSE-E-SE--EEEESSEESS-SSESSES--ES--EE--ESE-S-EEEESESSSS-SEE--EERE-SSEEEE--EE-SSESS-SSEEEE-EEES-RSSEEESSEEE--SEEESER-SESS-EEEE--EEESSES-S-EEEE-SESSS-EESS-ESES-SEES-SSRSSSESEESSESRSES-S-SEESSE--EE-ESES-EE--EEEESE-S-SEESRSEEERE-S-E-SSS-EER-ES-ESE-ES-SEE-S-SRSSESESSERSESES--EE-EE--ES--
      ***                     *|*        -EEEEESEESESERSESSSSRRSERSEESEESEESSESSEESSESREEEEESSEESSESEEEESESEERESEESEEESSEEEESSRSESEREESEEESERSESEEEEEESREEEEESSSESSEESSEEEEEREEEESSEESRESEESESERSERSESEEEESSESSEESSSSSEEESSSEEEREESSESSSSESSEESEEEEEESEESEESEEESEESSESSESEEEEEEESESSESSEESESEEEEERSEESESSSESRSSSESSSSSEEEEESSEESEEESEEEESSSSESSSEESEESSEESSESEEESESESSSESEESESESSSESRSESSRESESSREESESEEEEEEESERE
      *|*                     *|*     ---SREEESEESESSSESESSEEEESERESSESEEESESEESEESSSESSERRESSESESRRRSSSEESSSREEESEESSSESSRESEEESSSESESSSEEESEEEEESEESERESESSEESESEEEESEESSEERESESEREESSESSESRSERESSESEESEEESRSRSEESEREESESESSESESERREESESESESESEESSSESSESSSESESSSSSSESEESSSRESEEEESEEESEEEEESSESEEEEEESEEESSSSESEESEEESESESEEESSEESESEEESEEERSEESSEEEEEEEEESSSESESESSEESEESSSESSSSESSSEESSSEEESESRSESEEESEESSES
      *|*                     *|*  ---ESSEESSESEEEEEEEESRSSESSEEEEEEEEEEESEEESEESSESSEESERESSEESESEEREREESESSESSEEESEREESESEESESEEESSEESESESESESESSSEEEEESEESESEEEESEESSSSESEESESESEESESSESSSEEEEESSEEESEEEESEESEEESSRSEEEEESSSSSESESSEESESESEESESESSESESESSEEESESSSEEESEEEESESSSEEESESESSEEEEESRSEEEEEEEESEESSSSSSESSESRSEEESSESESESESESSEERSEEESSEEESSSSSSSSEESESEEESEEEESESSESSSSEESSESEESEEEEESESEEESEESEREE
       |                       |  -RSSSESEEESSRSRSRSEEEEEESEEESEESESSEEEEESESEESEESRESEEEEEESESEESSSESESEESEESESEEESEESEESSSSSEESSEESSSREREEEEESESSESSSESSEESEEESEEEEEESESEEESSSSSEESEEEEESEEERESESSRSEESSSSESSESSSSSSEEERSEEESEESSEESESEEEEESSEESEERESSSEEESSSEEERSSEESSEESEEEESEESSSSESERSEEESSSSESSEEESESSEEEESSSREEESESEEEEESESEESESSSSSESSERSEEEEEESESSEESSSSSESSEESRSEEEEEESEEESEEEEEERESSESEESSEEEESSEEEE
       | --                  - |--EESSEESEESSSSEEEEESSESEEREESSEESSSEESEESEESESEESEEESESSSSSSEESERSEESSEEEESESEEEEESESESSESEEERSRESESESSREESESSEESSSEESESESSSESEEEESESEESEESSSSREEEEESEEEESSSSREESSSSSEEEEERSESSEESSSEEESESEEEESESSERSRESEESSESESSESSEESSSEESSEEEESEERESESSSSRSSSSEEEEEESEEEESSEEERSESEEESSEESSEEEEEREEEEEESESREESESEEEESESSSSESSEEESEEEESSEEEEEEEEEEEEEEREESSEEEESESESSESEESRSSSESSSEEEEEEEESSS
       --SR-                -E--EESEESSESESSESESESSESESEEESESRSEEEEESSESESSSSESSEESEEESEEEEESEEESESESSSSREERSSEEEESESEEEEESSSESSSEEREEEEEEEEESSSESESEEESREESSEEESEEEESRRSSESSSSRSEEEESESSRSSSESESSEESSRSSSSEEREESEESEEEESREESSEEEESEESSEESSEEESERSSSSSESSSEEESSRRESSEEESSESSSEEESSEEEEEEEEESSRESSSSSEEESSEEEEEEEEREEEESEEEESSSSSEEEESEEESEEEEESSSESSSSEEEEESEESEESSEEESEEEEESSSEEESEEEEESSESSSESSSSEESSEEESESSEE
     --EESEE--         - ---EESEEEESSRESESESESESEESSSEEREEEEESSSSSEESSSREESEESSESEREEEESESSEEESSEESEESRSEESEESSEEEEEESESSESSSSESSSSSSSSESEEEEEESEEESSREEEESEEESSSESSSEEERREEREESSRSSESSEEESSSSSEESRSSEEEREEESSEESSSRESEEEEEEEESEEEESSSSEESSSSRSRSSEEESSSSEEEEEEESEEESEEEEEESEEESSEEEERSSESSEEEEEEEEESESRESEESEREEESSSSESESSSESSSESSSEEEEEREEESESEEEESESSSESSSSSESEESRRESEEEEESRSERSESESSSSEERESSESRSEEEESSSESSES
    -EEEEESESE--  -   -E-RSEEEESSSEEEEEEEEESESSRSSEREEESEESESSEEESSSEEEESEESEESSSSSEEEESSSEEESSERESESSEESSSRSESSRSEEESSEERESEESSESSEEEESEESESSSSESEESSESSSESESEESEESEESSEEESEEEERESRESEEREESEEESSEESSSSSSESRESEERRSEESSSESSSSSEESSEESSSEESSSEESESEEREEESEEEESRREESRSEEEEERSSEESEEESESESESESESESSESSSSSESEEEEESSEEEEESSEEEEESEESSSESSEESRESEEESEEEEESSSSSSEEEEESSEREESEESSESERESEESESSSRSERSSSEERESSEEEEEESSSSESS
   -ESESSSSESESE--E---SESRESESESEEESSEEEESESESSSESEEESESEEEEESSEESSREESSRSSEEESSEEEESESESSSEEESESSESSEEESEESRSSSEESSRSEEEESESEESSEESEEEESSEESEEESSESEERESESESEESESRSESESREEEESEESSSSSRSSEEESERRESSSESEEESESEEEESSSSESSSEEESSERSEESEESSSSSESSSEESEEEESEEESSEESSEEESRREEESSEESESSESEESSEEESEESSRSEEEESEESSSSSEESEEEEREREEEESESSEEEESSESEESSSESSSESEESEESESSSSRSREREESESSSEEESSSEEESEESSESSEEERSEERSSSESEEEEESEESSE
 --EEESSESESSESSEEEEEESESESSSEEESEESSEESEEEERESEESSESEEEEESESSESSSESEEEEEESRSESSSEESSEEEEEEESSRSESESSEEESSEEESSESEEEEEEESSESESSEESEEESSEESSESEESSSESSSSSEESESSSEEESSSRESEESEESEESSEESSESESESEESSSESESESEREESEEEEESEEESEESRESSSSSEEEEEEEEESSEEEEEESSEESSSSESEEEEEEESSSSSSESEEESSESEESESEEESESREEEEESEEEEESESSEREEEESSEESRSSSESSSEEESSRRESEESSESRESSSSSESSESESSSESREEEESSESSEESSESESSEEEESESESEESERESESESESEESSERE
-SSESSEESEERSSEESEREEEEEESSSSRESEEREEEESSEEEEESSEEREEEEEEESEESSESEEEEEESSESSSSSSESSESESSSSEESSESESEEESSESSEEEESESESERSSSSSSESSEERSSESSSESSESESSESERSEEESSEEESESEREEEERSSESESESEESESESEESRSEEESSSEESESSESEEESSEEESEEESEESRESRSESSSEEESESESREEESSEREEESRESEREESSRSSSESEEEESESSSESESSEEEEEESSESEEESEERESESEEESESSSSSSSESSSEEEEEESSSSSESSSEEESSEESERSESEESESESEESESEESESSEEEEERSESSSSESSESSSEEESEEEEESEESEEEESSESESE
EESSSSESESESSEESSSEEREESESSREEEESEEEEESESEERSRSSEESEEREEESEESEESESSSSSSSESESSERSSEEEEESEEEESEEESSEERSEREEESSSEEESSEESEEEEEEEEEESESEESEESSESEEESSESSSSEEESEEEESSEESSEESESSESSSSRSSESSSESEEESSSEEESSEEEREEESSERESREEESESEESRSSESEESESEEEESSSRESESESEEEESSESEEESSSSSSEESREESESESSRRESSESERSSSSSRESEESSSEESSSSESSSSRESEERREESEERSEESESSESESERSESSSSEEERSEESSSEESRSESRESSRSESESSSESRSERSESSESESSEEESSSESESESSEESESEEE
EESSSESSSRESESSESEEEESRSSEERRRSESEEESESSSSESESSEEESESSSSSSSESESESSRSERSESESSSESEESSSEEEEESESSSSESEEEESESSESERERSSESESSESSSEEESRSRESRSERESSSESREEESEESSRSEEEESSESSSESESRESSSSEESSESESSESEESSEESSSSESEEEEESSSSSESREESEESSEESSESESESSESSSESESSESSEESSSESSSESSSEESSEESSSSSERESEESEEESSSSSSSEESEESERSESEESEESSESEEESSESESERSSSEEERSSESSRSESESEEEEESEEEEESESSSEEESSESSESESESSSSSESSESRSSEEESEEESSSSSEEESSESSEESEEEESES
SEEEESESSSSSEEEEESSEEESSSESEEEESRSSREESSEESESESEESESSSESEEESESSEEESSEEEESEEEERESEEEEESEEEEESSSESSSSESRESSEEESESEESEESESEESEEERESEEEEEEEEESEEEESEERESRSSERSSSSSESSSSRESEESSSESSSSESEERESEESSSEESSRERESEESEEESESSSESSESREESSSSSSRESEEEESSSSEEESEERSSESEEEEREEEESSESESEESESSSEESESEEEEEEESEEEEEERRESESESEEEESSSEEESSRSSSSESESESSSSEEEEESSESSSEEEESEESSRSSSESSSSESSEEEEREEEESESSSESSESSEERSEEESSSSESSEEEEESEEEEEESSE
EESESSSEESRSEESEEESESESEEESESSESSSERSSSESEESSSSSSSESEERSRESSSSSSRESEEEESSSERSSRSEERESEEESSSEESESESSERERSSESSSSSESEEEESEESESSESREEESSREEESSEEEEREESEESESRSSSESESESSEESESEEEEESSREESEESSESEEEEEEEESSEESRESESSEESSSSSRERESESEESSEEESSERESEEEEEESSSSSEESESESSRRSSSEESSEESSESRSSSSESSSEREEESEEESEESESESSEESSEEEEEEEESSSSESSESESSEESESERSSEESSSESEEREERSSREEEESEEESEEEEEEESSSSEESESSRSEEESSRSSSEEREESSSEESSESEEEESSSES
SESSSSSSEEEESESSEEEEEERESEESRSSSSERERRSSESEEEEEEESSEEESSESESSEESRRERSEESEEESEESEESSSSSSSSEESEEEESESSEEESEESEEEESESEESSRSREESSSSEEEESSSEERESEESESESESEESSEEESSSSSSERESESSSEEESESESSSESESSEEERSSSESSESSSSEESSEESESSESESESEESESEEREEEESEESESSSREESSEEESSESESREEESEERESSESEERSSEESSEESEEEEESESSEEESEESESSSSESESESREEEESSSSSEESSSSEEESEESSEEEESSEEEESSEEEESESESEERSESSSEEEEESEESSSRSSRSESSSSSERESEEESEESREESSSSEEEESE
ERSSESERSESEEESEEESREEEERRESEEEESSSSEESESESEESSEEESSEESSRSSSEEEESEESSSESSSSSEEEEEEEEERSEESSEEEEESEESEEESEESEESSESSSSEESESEEERESSSSESEERSSSSSSESESSESSEEEESSSSRESESREEEEEESESRSSERSSSESEREEESEREESSERSSESSESRESEESSSESEESREESSEESSESSESREESSSEEESSSSESESSESSEESSESEEEEESSEREEERSSSEEEEEEEESESSSSSESSESRSEESSEESSESSRSESEESEERSSREEESSEEESESESEREEESSSRSESREESSEEEEESEESRSSSSEESESSEEESESSSEESESSSSRERSEESSESSEEES
EEEESSSSSSSESESESSSESERSSSSSSSEESSSSEESEESSSSEESSEESERSSEESESSSSESRSEESRRSSSESEESESSSESSEEESEEEEEERESESSSSSEEEEEEEEEEEESSEERESESESEEESESEEESEESSSSSSESEESSSESSEESESSREEEERSESSSSSEESSSSESESEERSRESSEESESEEEESSEESSSEESSESESRRERSSSSSEEESESSSESSSSRSSESSSSSREEESSSSSRESSEEESREEEESEESEESRESEEESSEEESESEEEESSREERRSERRSESSSRESSSRSSESESSSEESSSRRSEEEEESSESEEERSSRESSSSESSSESESSSESESSSSESEESESSSESSERSSSSSSSESSESE
ESESSSSSSEEEEESSESEREEESEESSSSSRESERSRSEESSSSESSESERSSEEERESESSEEEEEESESESESEEEESESESEEESSSESESSEERSESSSSSSEESSSEEEESEEESSESRESEESEESEEESEESRRSESESSESSEESSESSEEESESSESSERSSESEERSSSSESSSESRSESESEERSSSSSSSEEEESSESESRSSESESESSSSESESESRSEEREESESRSEEEESSEEEEESSERSRSSSEESSSESSESSEESRSESSEEESESEESESSSSSSESSERSEESSERESESREESSSRSRSRSSESERSSRSEEESSEESSSEEESSREESSEERESSSRREESEESSSSSEESERSSSSSSEEEEESESSSSEESS
SSSESSSSESSSEESSEEEERERSSEESSSEESSSSSESSSESSESEESESRESERSRRSEESSSSEEESSSESSSSSREESSEEEEESESESSSSSEESEESEERSESSESRSSSSEERESSESESEEEEEEESESSSSSEESEESSESEEERSSREEESESSEEEESESSRSESSSEEEESSERESSRESRRSEESESSREEESEEEEEEESSESSSEEEESSSRSEESSEERSEESESEEEERRERSSERSESEESSEESESEESESEEESSEESSESEEESEERSEEEEESEEESSESSEEESEEESESESSESESEEEEESSESESESSRESSESESSSEEEEESREEESESSSSESSERSSSEESEEEEESESSSSSSESEEESSSSSESEESS
SSSSEEESESESESSRESSSSEESSERRSSEEREESESSEESRSSESEEEEEESREEESSESSESEESSESSSSEEESSSSEEERSEEESEEEREESESSESSSSSSEESSSSSESSESSSSSSESSSRSESSEEESEESESSSSEEEEESSSSSESESESRSEEESRSSESSESSEEESESERSSRESSESSESESSEESEESSSEESEREEEESSRREEESSSESESSESSSSSESRSESESSEESREESSSSESESEEESSESESSESSEESSSSEEEREESSEEESSESSEEESSESSEESESSESESSEEEESRSEESSESEESESSERSEEESSEEESESEEESSSEESSSESEEEEEEEEEREEEEEESEEESSSEESSEESEEEEEESSSSE
SESSSESSSSESEESSRSSSESSEERSSRSSREESESEESSSESSSSSESRSRSSESRESESEEESESRSREESESSSSRSRSSESSSESSSSSSERSSESSESEESESSSSSEEEESESSSEESSEREESSEESEESSEESEESEEESSSESSSSSSESSSEEESSSSSSEESESREESSSSSEEEEEESESSSEESRRSEEESSSSSSSESSSESEESEEEESSSESSERSSSERSEEESSEEESSSSSEESSSESESSESRSRSESSSSSESSSEESESESESSSEEEESSSESRESEESSESESSSSSSESEEESSESERSEESSSESSEEESSSEERSEESESSSSEEEESSESESESSSERSSRSSSSSEERSESSESEESSSEEESESEERES
ERERESSEESSSSESEESSREESESEEEEEEESSESESEESSSESESEESSEEESSESRSSSRSSSEEESRESEEESSEEEEESSESSSEEESSESRESEEEERESSRESSEEEESSEEESSSSSSSESSSSEESSSESSEESSEREEESSEEESERRESSESERSSESSRSSSSSESRESRERSSSEESEESESESSEEESSSEESESEESSEREEESRESSESSESESEESEESESSSSEEESSEEREESEERESSESESSSESESSSESRSESSSRESSSEEERESESERSSRRESSSSRESSSESSSSESSEESEESEEESSSESSEESEESEESSEREEESESEESSSEESESESSSSSESSEESSEEEESEEESSSSEESEEEESSSESSESRE
SSEESSEEESESSSESSEEESRSSSSSSSESSSESSESSESSSSSSSSSSEESEEEESSESSEEEESESEEEESSSESSEESSESSSSSSESRSSSSSSSSSSESSEESSSSSSESESSSEESERESSSEEEESEESEEEEESESSEESEESEESSEEESEESESESSESEEESSEEESESESEESSRESSSRSSESEREEEESSEEESESSSSRSSESESESSESESSSEEEESSRERERESRSSESSSSEEEESSEEEESERSSERSRSEEESSSSESERSSESEERESEEEEEEEEESEERSEESESESEEESSSESEESEESSEERSESESSRSEERESESSSSSEEESSSEESESEESSSSERSRSSSRERSSRSREESSESESRESEEESSSES
SESSESSSSESESEEESSSSEEEEESSSRSESEESSEESESSSERESRSESRSSREESSEEEREESRRSESESSEESSREESEEEESSSESSSSERSSEEESSESEESSSRSESSESSESESEESSESREESSSSRSSSSESEEESSEEEESSESESSSEEESESEESSSEESEESEEESSSSESSESSSSSESSESSSSSSSEESSESESESEEEESSRSESSSRSREEESEESSEESSSEESEESSSSSEEEESEEEEESSSRREREEEEESESEESSSEESRESSESSSSSSESSSREEESEEEESESEEEESESSSESSEESSEESSSEESSESEESSESSESESSESSEESRESESSESSSSSESEESEESSESSEESSSREEESESESSSSESE
RRESSSSSSESRSSEEESEERSSEEEESSSEEESSEESSSSERSSRSESSEEEEESRREEESEERESSSSESSESSSEESSESESRESSESSEEEESSESEESSRESSSSRESSESERSEEESESSSSSSEEERSSESRSESESSESSSSEEEESSSEESEESEEEESESSSESESRESESEEEESSSESSESSSRESEESEESEESEEEESESESSSSSEESSSSSESSEESSSSRESSESSSSSSEESSSSSSESSEEEESSSSSEESEESSSESSSSRSSSSEESESSEEERRSESREEEESEERSSRESSESESESEEESSRSEEEEEEEEESESSSSSSEESSSESESSSSESRSSEESERREESSEEEEEEEEESREESSSESRREESSSSEEE
EESSESSSRSSSSEEREESEESEESSSEEEESESSESSESRSSESEEEESSSSESSSSSESSREEEESSSSESESRSSESSESSSESSESSSEESRSESSESSSSEESSESSESESSESSRESEEESESESSSESSSSEESSESSESEEESSSESRSERESREESSSRSSSESSSSESESRRSSSSSSSESSESEESSERSSSSESSEESESEESESSESEESESRSRSSSEESSSSSESSRESSREEESSESSRESSEESEESSESEEERRERSEERSESESESSESSEEESSSRESSEESESEREESEESSSSSRESESSSESEESERESRESEERSESSSESSSESSSESSSESSSSSESEESSSEESSESSEEESESSEESSESESSRSSESEREE
SSERSSSSEESSSSSESEESSSESSSESESESSSSEESESEEEEEESSSEESSSSSESRRSEESESSEEEESESEEEEEESEEESEESEESESESRSESESSESEESSSSSESRSSSSSSESSESRSSSESSSESSSSSSSEESSESEESSSSSSSERSSESSSEEESESESSEESSEESESSESRESESSSSSEESSSESSSSSERESSSRSSESESSSSESSRSSSSSSSESESESSSSRESSESESSSESRSSSSRSSESSSSSSSESESSSESRESSSSERSSSSESSESSSSERSSSEESSESESSSEESSSRSSSSSSEESEEESSSSSSEEESESESERSEESSSSSEEEEEESESESSEEESSRSSRSEEEESEEESSSEESSESESEEESR
SSREESEERSEESESSRRSSEESSEESEESSSSSSSESSSEEEESSRSSSSRSEEEESSESSSRSSEESSSSSSSEEEEESEESESSESESESESEESESRSESESSSERSESEERSSSSSRSESSSEESEESSSSSSSRSSESREESSSSSESESSRESSESRSSESSESSESRSSSSESSRSSSEESESSEEEESSEESSESEESSSESSSSESERSSEESSESSSSRSSRSSSSESSESESESESSSESSSSESSSERESESSSESSEESESSESSSSSSSSSSRESESSSSRSSREEEESESEESSERESESEREEEESSRRSSSESSSSSEESSESEERESSSSSSSEEESESSSSSSSEEESSESESESESESSSSSSSSRSRSEESSSSSESE
SSSSESSEEEESESSRESSSERSSSEESEEESRSESEESRSESSSEESRESESEESESEEEEEESSSSEEESSRSRSSRSRSSESRSSERSSSESSSEEESESRSSSRESESEESSSSSSRSESESESEEEEEESEESRSSESSSESSSSESRSSESSSESESSSSSSSSEEESESSRESSRESSREEEEEESESSSSSSRSSSSEESEEESSSEESEESSSSSESSRESSESSSSESSSESSEESESSSSRSSESSESSSRSEEESSSRSSSSEESESSERSESRESESSEEESSSESRESSSSERESSEEERSSSRRSRSERSRSSSESSESSEERSEEEERSSRESEEREESSESSSEEESEESSRSSRESSSSSSEEESESEEESSRESESESEEE
SSSESESSSSESESESSSESESEEEEESSSSSSSSSRSSESSRSSSEEESSSSEEEESESSESRERSESESESSSSSEEESSSSRSRESSSESSSESSSEEEESSRSESSSSRESSSSSSESESESSESSEESSSSSSSSERESSSSSESRESEEERSSSESESSSSSSRRSESSSESSSEESSEESSSSSSEESRESSSESSRRSSSESEESSESESSEEESSSSSRERSEESESESSSRSSRSSSSSESSESSSSRSSEEESSERESESSEESSSSSSSSESSSESSRSRSSEESSSESSESESSSESESSESSSSSSSESESSSSSRSSSRSESESSSESSSSSSEESSSEESRSSSSESSSSSRSRSSSEEESRSSESSSSESERSEERSEESSES
ESSSSESEESESEESESSSRESESESESRSEESESESSSESESSERSESSSRRSERSSSRSSSESSSESSESSEESESRSEESSSSESESSSSEESSSSSSRSESEEESESERESSRSSESEEESSSSSESSERSSEEEESSESSESSESESSSSSSSSESSSRESEESSSSSESSEEREEEESSSSSESEESSSESSSSSSEESEEESESSESSSSSSESSSERSSSESEERESEESSEESSESESESSESSEESSERSSESSSERSSSESSESEESEEEESESSESSEEESESSSRSEEESERSSRSESSESESSSRSRSRSEESSSSSEESSEESSSESSEEESESSSESSSSSSSEESSSSRSSEESREEESSEESSSSSERSSRSRSEESSREES
