                                                                                                                                                                                                                                                                                           ***                 *|*           *|*                       *|****                      *|*     ***         *|**|*   
                                                                                                                                                                                                                                                                                           *|*                 *|*  ***      *|*                       *|**|*                      *|****  *|*         *|**|*   
                                                                                                                                                                                                                                                                                      ***  *|*               ***|*  *|*      *|*                       *|*||*       ***            *|**|*  *|*         *|**|*   
                                                                      ***                                                                                                                                                                                                             *|*  *|*               *|*|*  *|*      *|*                  ***  *|*||*       *|*            *|**|*  *|*         *|**|*   
                                                                      *|*                                                                                                                                                                                                             *|*   |                *|*|   *|*       |                   *|*   |*||        *|*             | *|*   |           |  |    
                                                                      *|*                                                                                                                                                                                                              |    |                *|*|   *|*       |                   *|*   |*||        *|*             | *|*   |           |  |    
                                                                      *|*           ******                                                                                                                                                                                             |   --  - -    -  - -- | -    |     -- -  - - --  ---  -   -| -  - |-   ---- -|-   -   - -- ----|  - --  --- -  --  --   
                                                                      *|***         *|**|*                                                                                                                                                                         ***             --- --- ES -S E  - E--E-EE | E----|-   -SS E  E-S-ES- SEE--E - E|-S- E-|S- -ESSE S|R---E---S-ES SESE|- E-EE -ERE-S  SE -RE - 
                                                                      *|*|*     *** *|**|**                                                                                                                                                                        *|*             REE-ERE-EE-ES-E--E-EEEREEE---EESSE-S---EEE-E--ESSEEES-SSEESS-S-E-EEE-EE-ES-EESRE-S-SSESESEEESEE-ERSE-S-ESSE-ESEEEE--ER-ESE-S-
                                                                       |*|*     *|* *|**||*                                                                                                                                                      ***       ****    *|*            -ESSSESSSEERSESEEEESEERSEESSEEEEESEERSEEEESREEESEESEEESEEEEESESSESSSESSEEESSRSSESESEEEESSEESSESSSEEEESSEEESREEESESESSSSSEESSSS
                                              ***                      | |      *|* *|**||*      ***                                                                                                                                            **|*  ***  *||*     |         ----EREEEEEESSESEEESSSREEESSSSSSEEESSSESSESESSSEREESSEEREEEEESSESRESSEEEESEEEEEEEEEEESSESEESEEESREESSESSEESEEESSESRSSEEESESEESESSS
                                              *|*               -    ----|      *|* *|**||*      *|*                                                                                                                                            *||*  *|*  *||*    -|      ---SESSESESSESSEESESSEEEESSSREESEEERSEESESSEREESREEEEESESSEEEEEESEERESEEEEEESSEEESSESSEEEEEEESESESESEEESESESEESESSEEESSEEERSEEERSEEEE
                     ***            ***       *|*              -S----SEEE-      *|*  |  ||       *|*                          ***                                                                                                               *||** *|*  *||*   -S--- - -ESESEESSEESSEESSEESSESSSSSESSEEESEEESSEEEREEESSEESEEEEEEEEESESEREESSESSEERRSESSEEESEESESSSEESSESESSSESEESEESEESSRRESEESSSEESEEESSEEES
                     *|*    ***     *|****    *|*         -   -RSSSREESEEE--     |   |--||       *|*                    ***   *|*                                                                                                               *|||* *|*  *|| ---SSSES-E-SSEESRSEEREEEESEEESSEEEEEEESEEEEEEERESESEESSESSESESEEESSSSSEEESSESSESSSSEEEEREESESREESSESSEESESEEEESEESSEEEESESEESESESESESSSEEESEESEES
                     *|*    *|*     *|**|*     |    --  --E---SRESESESESSESE--  -|   -EE---      *|*                    *|*   *|*  ***                                                                                                           |||* *|*   ||-SEEEERSSSSEEEEEEEESESESREEEEEEEEEESEEEESEESEESEERSEEEEESESSSEEREEESESRESEEEEEEEEESESSSSSESEEESSSSSSSSSSEEEESSERSEEEEEEEESSEESEEEESEEESESSESSESERS
                 ---- |     *|*     *|**|*   --|   -ES--SEEESESREEEEREEESEESES--E----SESSSS- --  *|*                    *|*   *|*  *|*****                                                                                    ***                |||   |    |-ESEESESEESESEERSEESRESSEEESEEEESEESRSSSEEEEERSEESRESSREEEESSESERSEESRESEEEEEEESEESSEEEESEESESESSESSSSESESEERRESEEEEEEEEESESEEEEEESEEEEESSSEEEEESES
               --ESSE-|      |       | *|*  -SS-  -SSESSESRERESSESEESSEEESSSSESSSERSSSEEREEE-RE-  |           -     -   *|*   *|*  *||**|*                    ***     ****        ***  ***                                    *|*                -||   |    -SSEEESEESEESEEEEEEESERSSSERSESSREEEESEEERESSSESESSESESSEEESESEEESEESEEESSEESSESESESSEEEEEEREEESRESESSESSSESERESSSSRSEESSERESEESEESRESSRESEESEEESREE
            ---RSEEEEE-      |       |  |  -SSSE--RESEEESEESSEEEERSESSSESSEREESEESSEESESEESSSESE--| ---  -----E- - -E-- *|*   *|*   ||**|*                    *|**    *||*        *|*  *|*                            ***     *|*  ---        ---E--   -----EEEESRSEEESEEESEEEESSRSEEEESESEESESEESEEESESESEESEEESSEEESESEESSEEEEEEEEEEEEESEESSSESEEEEEEESEESSSSESESSERESEEEESESEESEEESEESSEESSEEESEESESSEEESSSES
     -- - --ERESEEEEESE-------- -  -----|--SSSSSSESESSSEEERSEEESESSESSEESSSEESEESREEEEEEEEEESSEEES--EES--EEEEERR-E-EESS- |     |    ||  |                     *||*    *||*        *|*  *|*                            *|*      | --SSE- - ----SSESER---SSSSSSSSEESEESSSEEEEEEEESESEESSEEESESSESEEEEESSESSSSSSEESSSESRSSSEEESSSSERESSRSSESSESESEEESRSSSSERSSSESEEEEEEESSESSEEESSEESSEESEEEEESEEEESESSSSESSSSSEEEE
    -ES-S-EESESEEEESERSSEEEESSS-E--EESSE-SEESSSSSESSESSEESESSEEEEESESEEESSESEESSESSESEESSSESSEEEESSRSSRSRSSSESESSESSEESE-|     |    -|--|                     *||*     ||         *|*  *|*                            *|*      |-SESSSE-E-RESSEERESSSRSSEREEEESRSESSEEEESEEEEESESSERESRSESSSEEEEESESESESEESSESSREEEESSSEEESEEEEEESRESEEEEREEESEEESEESREEESSEEEESSESESESEEESSESSESESEEESSSSESREESERSSSSERSSSEERRE
   -EESEEERSSSSRRSSEESESRSSSESESSESEESSEESEESESESSSSEEEESEESSESSESSEEESSEERSEEEEESSSESESEERSESSSSESESRESSSSSERRESSESESSSE-     -----S-EE---                    ||*     ||         *|*  *|*              -              |       -EEEEESSEEESSESSEESRESSSESESSSESEESSEESEESESESSSEESESSEESSRSEREEESEESESEERSEREESESEEESERESSRSESEEEEEEESSSSSEESEEEEESERESRSEEEEESEEESSEEESESSERESEEEEREESERSESEESSESSSEEESEEESRESS
---SEEESEEEEEESSSEEESREESSEERSESSESSEESSEESSSESSEEERSRSERESSSESSSSSEEEEEEEESEEEEEESRERSESSRSEEESREEEEESREESERSEEEESESESESE-  --RESESSEERSEE-                  -||      --         *|*  *|*           - -S---          -|     --RSSEESSESSESEEESSSSSSERSSEESEESEERSSESEESSSSEESSSEEEEESEESEESEEESSEESSEESESEEEEESESEEESESESESEESESSEEEEERSESEEESEEEESESEESSSEEEEESEEEESSESEESESSSSEEESSESSSEESESEEEESESSSESSSSRSS
SESEERSESSSEEEEESEESEREESEEEEEEEEEESESESSSSESEEESEESESESESSESESESEEESSEEERSESSESSSSSEESESESESSSEEEESSSESSSSSRSEEESSSSRSEEES--ESSEEESSREEEESS-----           --E-|--   -ES----      |    |     -  ----E-ERESE-- - -----S--- --EESSESESSSESSSEEEESSSEEESSSEEERESSSEREESESSSESSESREEERRSSREEEEEERSEEEEESEEEESESRESEESSESEESESESEEEEEESERESSSSSESEEESEESSERSEESESSSEESSSSRSSEEESESESEESESSEESESESESEESESSSSSSESSERRR
EEREESSESSEEESESSSSSSSSEESESSRESERSSEERSESESESEESEEEEESESSEEESEEESEEESERSSSESRESESEEEESSRESESSEESEEERSSEESSEEEESESREEESESESESSESERRESEEESESEEREES-    --- --RSEE-RS---RSESSSR---   |    |--  -S--EESSEESEESEEE-S-SEREEESEE-SEEESESESSRSSSSSSEESEEEEEEESESESSSSESEESESRSSSSEEERESESEESEEESSESSRRSESESSESESESEESSESEESSSSESESSSEESEREESSSEESEEEEESESESERSESESEESRESEEERSEEEESSESSSSSRESESSSEEESSSSESESSESERRSESERE
EESSSSESSRSESRESSEERSESRSSESSEESSEEEEESESSSSEESSSESESESEESEEESSESESSEEEESESEESSESESSRSEESSSESSSSSSSEESSRSSSREEEERREEESESESESEESSESSEEESESSSSESSESE----SEE-SSESRESERESSSSSEEESSES-  ---  -SE--SEEEESEESESSEESESERSEESESEEESEEREEREEESRSSESEEESSRSESSEESSSEESSSESSSSSRSSESESESREEEEERESEESSSEESESEEESSESEERSEESESSSEEESSRSEEESESESSRSSSESEEESSSSESEEESESESSSSESESESSESESREESEESEEESEESSESSSSESSESSEEESSSESSESSSSRE
SESSEESSESSEEEESEEEESSESSSEERSESESSSSERRESSESSEESSSSSSSRSESESSSSREEESEESEESSESSSESEEESRESESESESESSEEEEESESESSSESEEEESESEEEEESEEESEEEESEESSEEESSESEEESSEEESESESSEESESESEEEESEERRES--EES--SSEEEESEEEREESEREESEEEESEEEESSESEESSERSEESESEESEEEESSEESRSEEREEESEESSEREERSEEEESSSSEESEESESESESESSEESSEESEESESESREESSSSEREERSSEESSSSSSSSEEESSSRSEEESSSSRSEEESSRSESSESSSESESEEEESEEESESSSEEESEEEEEESESSSSESSSSRRSEESERSEE
EEESESSEEEESESRESSSSEEEESRESSSESEESRSEESSREESERSEEEEEESEESESESSESSEEESESSSEREESESSEREERESEESEESSSEEEERSSEESSEEESESESSESSRSESESSSSESEEEEEEESESSSSEESESSSEESSSEESSSSSERSSSESEEESESESSEESSEESSSEREERSSEEESSESERERSEESSSSEESESESSESSESSSEESESESSEEERESSEEESRSESESESSERSSSESERSESESESEESREESSSSESSSSESSSESSEEEESRSERSSSESSEESESRESSESSEEESEEEEEESSSEESREEESSSSEESESSEEESSRSSEEEEEEESSEESSSSEEESERSSSSSESSEEESESESESSS
SSESSSESESSESSESSSSESEEESSSSSESSEESSSEEEEEESSSSSESEESSSSEESSSSSSREESEEEEESSSSESESEESSSERESSSSSSSESRREESESESEEEEESEEESSSEESEEEESSSERSSSERERSESRESSRRSEESEEESSEESREEESSSEEEEESSESSSESESSESESSESESSESEEERRESSEESSESSSESSEEREESEREEEESESESESSEESESSSSESSEERESESESRESEEESSESSSESSEESSSSEESSRESSSREESSSEEEESEESSSSEEERREESSSESSSRESERSSEESESSREESSEEEEEESESESESSESSEESESEEEESESEESEEEESESSEESEESEESRSSESSESREEEEESSSES
SSESSSEESSEESEESEERSSESSESSSEESEESSSEEESESEEEESSSESSESSSESRESESESSSSEEERSSEEEESSSSSERRRERESEESSESESSESRSSSRSESERSERSRESESSSEESERESESSSESSSESRESSSSESEESSESSEEEERSSEESSEESSEESEESSEESESSREESERSSEESSEESSESEEEESESSEESEEREEESESEEESEEEEESSERESERSESEEESESESESSSSSSSESSEESSSSSSEEEESSEEESESEEEESESREEEESERSSESEEEESSSEEERSSREESRESSERSSESSEEESRESSESSEEEESSSESSREEESSSEESSSSSSSSSRSSSSERSERSESSESEEESEESSEESSSRSEEE
SRESSEEESSEEEESSSSESSRESEEESSSESEESESEEESERSSESRESSSEESESEERRESEEESEESEEERSEESSESEEEESSESSSSSSSSESEREESESESSESEERESSSSEESESRSSSSEESSESEERSESESESESSESSSEEESSSSESSESEESSEEEEESSSSESSSEESSESESEESSSSESEESEESEESSSSSEESSSSSSSESRSSRESEEESSSESSSEEESSEEEEEESSEERSSEESEESERSSSEEESSEEEEESSEESSESRSSSEEEESSESESEEESESSESEEEEESEESSSSESESESEESESESEEESSESSESSSESSSESSEERSEEESERESSSEESRRSEESRSSSESRSSSSESSSSSSSSESSEESS
SSESESERSSESSRESSSSERSESESSESSSSEEESEESESSSSEERESSRSSESSEEESSESRSESSRSEESEESSSSEEEESESESEESSSERSRSESESEESSSSEEESSSEESSSSESESESESSESSESREEESSSSSESSESSSSEEEESSSSRSESSESSEEREESSESESEEESSEEESESSESEESEESESSSESEESESSSRESSSESESSSSSRRSSSEERSSSSSSESSSESESEREESEEEEESSERSSSESSESESSSSSSSEESSSESSSSSEEEESEEESSSEEEREREEEERESSEESEESEEEESESSESERSSEEESSSEEESEEESSESSESSSSESSSEESRSRESSRREESSERRESESSSSSEESSSEESRSSREEE
ERSESSSSSESEEEERSEESRSSSSESSEESSESEEEEEESESSSEESSSERSRERSSSESSESSSEESEESSESEEESSSEESRSESSEESESESSESEESSSSSESEREEEESSERSSSESEESSSSSERSESEEESESSESRSSRSSEESEESEESSRSREEESEESSSEEEESEERSEESEREESSSRESESSESRSSRSSRSESSESSESEESEEEESESESSESEEEESRSEESESRSSSEEESSSESSSSSRSSRESEEEEESSESSESSEEEESESSERESSRREEEESSESEESEEEESESSEESSESSSESEESSSSESSSEEESSEEERESSESSSSESEESESSSSSSEEESSSEEESSEESRESRESSSSSRESSRSESESSSRESS
ESRSSSSSESEESSSSSSEEREEEESEEERSESSSRSESESSSESEEEEEESEESSSEESSEESESSSESSSSESSSSESSEEESSSSEREEESSSESSSEEEESSSESESSSEEESRSERSEESESERESSSEESEEEESESEEEESSSSESEESSERSESRESSESSSESEEESEEEEESESESSESEESEESEERERESSEESSSSEEEESRSESERRESESSSEEEESSSEEESESSSSEESEESSRSEREEESSESSEEEESSEESEESSSEEESSSSRESRRRSESSRSSSERRSESESSRESSRESSRSSESSESEESEERSEESESEESEERSSEESSERRSESESSSSRESSESSESESSEESSESESSEERESEESEEEEESSEEEESES
SSSSSSEREERSEESEESSESESESSSSEEESSESEERSSESSESESSEERESREEEESEERSSSESRSEESESSSRSSSESSSRSESEEESEEESESSESESSESSESESSSSSSSERSESESSSESSSESESSSSSSESREESSSSSSESSSSEEEESRSSEERSSSESSSSESSEESERRESESSESEESSSSSEESSSEESSSSEEESSESESSEESRSSSSERESESSRESSESEESESSSSEEEESSEESSEERSSEREEEEESSESSESSSSSSREEESESEESESRESSESESSSSSSEEESEESSESSSSSESSEEERERESSRESEESSSSSESSEEESEEEREEEEEEESEEESEESEEEERSEESEERESSESSSSESSEEESREESS
SSESSREEESSESEESESSSSSEEEEESESSERSSESSSSEESSESEESESESSSSRRERREEEESSSSRRRSSERSEESEESSEESSERSESESEESRSSESEEEERESEESSSEESSSSESESEESEREEESSSEEEREREERESRESSSSSEEEEEESEEEEESEESEESERERRSSSESERSSSEESERSSEEESSSESRESSESSSEEEEEESESSSRSSSSRSSESRESSSRESESSRSRESSESESEEERSSSSEREEESSRSEESESSRSESEESSSSSESEEERRSSSSSSESSESSERSESEESSEEESSSESESESESSREERSSSRESEESSSESEEESEEESEEESSSESEESSSSSSSSESERSSEESESSSSSSRSSSEESSSSE
SSSSREESSSSSESSEESEEESSESSSSSEEEEESEESEESSEEEESSSRESESESESSRSESESESESRSSSRSSSSSESEESSRSSSESESESSSSESSSSSESERESSESSSRSEEESSSSSERESESSSSSSSSSSSESSEEEESERSESRSSSESEESSEESSRSESSSSERSEEEESEESESESESSESSRSRSSESESSSREESEESSSESSSSSREESEESERESSSESEEEEEEESSSSSESSSEEEEEESSSSESSSESEEESESSESESEEESEEEEEESEEESSSSESEESSSSSSEEESESEEESSSSSESEESSSEEESSSESEEEERESSEESESEEREESSSEESSESSSSSREEESSSESSSSSSSSSSEESRSSSEESEESE
SSESSSEESSSSSSRSSRSESSSRESSRSEESERSSSSSERSSSRSSSSESSEESSESESESESSEEESEESSRSSEESSESRRSSESSERSESESSSEEESSSSESSSEESESERSSSESESEERRESSESSESERSSSSRRRSEESSESSSEEEESEESSSSRSEESSESRESSERESSSSERSESSESSESEEEESSSESSSRSESSSSEEEESSEEEESESSESEESSSSESESSSSSSREESEESSESEESEESSSSEESSESSESSSESSSRSSREESESSRESSESSSSSSSEEEEESERSEESEERSEESSESSESEEEESEEEESSEEESRSEEEESSEEEEESSEESSESRSEEEEEEEEEESESEEESRESSSESSSSESEEESSESRS
EESSSSSREREERESSSESSSSSEESSSEESSSSEEESSESSESEEESSESEESSSESSSEESSEERSESESESSRSRSSESSEEEESSSSSSESSRESSESESSRESSSSESEESSSSESESEESSESSSSSSSRESSSSSSERSESEESSSSSSSSESSESESSESSSSSSSEEESSEEEEESESSSSSSSSESEESSEEESRSSSSSSSSSSSSESESESESRSESSEEERERSSSSSEEESESESSESESEESESSSESESSSSERSESESEESSESSSSESSRSSSEEEESEESEEEESSSSSSESSSSESSSESSSSSSSSSSSEESSEESSSSEESSESSESESSEEESSSSSSSSSSESSEESRSEESESERSSEEESSSESSRSRESSEER
SSESESSRSSSSSESSSSRSESESERESRSEEESSSSSSSESSESESESERESRESERRSSSSSSESSEESSSESSESRSSSSSSSSSESEEESSESSSSSSSSEREESSSEESRESSERSRSEESRSSESSSSESSSSSSSEESSRERESERSSRSEESSEESESSESRESSEESESSEESESSESSESEESESSERRESESSEESSESESSESESEESSSSESREEESERREEESEESESSRSRESSSEEESESESSRSESSSSSESSRSSSESSSESSSSESSERSEEERSSSESEESEEEESSSSSEESEEESSEERSSESESESESSSSSSESESESEEESESEESSRESSSSSSSSESESEESSSEESEEESSSSSSSRESESSSSEEERSEEE
EESEESSSSSEESSERSSESESSSESSEEEEEEESESESEESESSEESESSRESSSSESSSESESESSSEESRRESSESERSESSSSESSSSEEERRSESSSESEESSERSESESSSSEERSSSSSSSSSSSSSEEESSSESSSSSRSERSESSEESSEESSSSSSEESSESEESERSSEESSESEERSSESEESEESEEEESESSSESEESEERSSSSSEEESSESSSESESSESSSRESSSSSSSSSEEESRSSERRSRESSRSSEESSESEESESESSSSEEREESESEERRESRESSSESREERSSSSSRSEESSSSSSESEESESSERSSRSSSESSESSSSSSSSERSSSEESESESEEERSSSEEESSSSSSESSESSSESESSSRSSRSSRS
EESSRESRSRESSSSSEESSERESEEREESESSSSSEREESESSSSSSSSSSSSESSERRSEESSSESSSEEESSSSEESSSESSESSSSSSSSEESSSSSESSSRSSSESSESESSSESSSESESSSSSSSSSRSSSSRSRSSSSRRSSSESSSSSSSSSEESSSEESSRSEERSSSRSRSSRESESEESESSESSEEERESSEEESESSSSREESSSSESSRESSRSSREESSSSSSSSSEESSESESSSSSEEESSEESSESEESESEEEESSSSSSSSSEESSEESSEESSSESSSESEESESSSSREESSSSSEESSEEESEEEESESSRESESSSSSRSSERSSSSSSEEESSRSESSSESEESEEESSSSRESSSSSESSSRSEESSSESESS
