                                                                                                                                                                         *|*                              *|**       *|*     *|**            ***                    ***               *|*                          *|*                          *|*                                    *|*   *|*                
                                                                                                                                                      ***                *|*                              *||*     ***|*  ****||*         ****|*                    *|*               *|****             ***       *|*                          *|*                                    *|*   *|*    *** ***     
                                                                                                                                                      *|***              *|*               ***            *||*     *|*|*  *|**||*         *||*|*                    *|*               *|**|*             *|*       *|*                          *|*                                    *|*   *|*    *|* *|*     
                                                                                                                                                      *|*|*              *|*     ****      *|* ***        *||*     *|*|*  *|**||*         *||*|*                    *|*               *|*||*             *|*       *|**                         *|*                                    *|*   *|*    *|* *|*     
                                                                                                                                                       |*|*               |      *||*      *|* *|*        *||*     *|*|   *|* ||*         *||*|*                    *|*                |*||*             *|*        ||*                         *|*                                    *|*    |     *|* *|*     
                                                                                                                                      ***              |*|*               |      *||*       |  *|*         ||*     *|*|   *|* ||*          ||*|                      |                 | ||              *|*        ||*                          |                                      |     |     *|*  |      
                                                                                                                                      *|*              --|-           -  --     - ||    -- -| --|     -    ||       | --   |  -|    ---  --||-|--                 -- |-           -    - ||  -  -   -- - -|   -  -- -| -     ---  -   -- -   - - |      - --    -    -- -       --   -  |-   ----    | - |---   
                                                                                                                                      *|*             -SE|E - --  -- -S--ES--- -R-||- --SS-E--EE|- ---S- ---|  --  -|-ES---|  E|   -ESE--ES-|E-SE ----- ----- ----ER--E  --- -   -S-- -E --- E--R---EE S S|-- S--ES-S| S--  -EES  E-- SS-S---E-R--------S SS  --S----EE-S----  -ES---E---S---SSES -- |-S -EEE- -
                        ***                                                                                                           *|*             EES-E-E-SE--RS-ESSSSSSSE-SSS--S-SEEEEEESSE-S-ESESE-ESE---SE--E-ESSSSR---E----SEESESSES-EESE-EESEE-EEEEE-SSEREESSE--RSE-E---EESS-ES-ESE-SEEERREEE-S-E-ES-ESESSEE--SSS--EEEE--SSE-SESEESSSEEEEERSESSE-ES--ESRESEERSSEESES--EEEEESEEEEEESEESSS-SS--ES-EESEE-E
                        *|*                                                                                                           *|*            -EESSESSEEEESESESSEEESEESSESSRESESESEEESSEESESRSEESEESSERESSSSEEEEESSEEERSESEESSSRESERESESRSSSEREEESESREESSEEREESEESSSEEESSSESSSSSEEESEESEERSEESEEREEEEEESEESESSESSSSSESEEESEESSESRSSESREESSSEEEEEESSEEESESREEEESESESESEESESSEEESEEERSEESEEEEEEEEESSESSSESE
          ***           *|*                                                                                                           *|*          --SEESSSESERSSEESEESSSSSEESSSEESSEEESSSEESSSREESREEESEESREESSSSSESSEESSEEESSSEEESREEEESSREESEESEREEESEESSEERSSEEEESERRRESESSESSSEESEESSESEESESRSSESSESESSEEESEESSSESEESESSSSSEEEEEESESSESSSSEESSSESEESESESEEEEEESSSSSSEESESEEESSSSSSSSEEESSSSESSSSSEESEESEEEE
          *|*           *|*                                                            ***                                             |          -SESSESSEESESSESSSSESSSEESESSEESEEESESSERESEEEESSEESEESSESRESESEESSEESESEEESEEESSSSESESSESSSEEEEESESSESEEESSSESSSEESSSRESRSEEEESREEESEEESESRERESSEEEEEEEEESESESSSEESEESEEEEESSESSEEESSESSSSSSEEEESEEESESESSEERESEEEESESESEEEEEESESEREEESSSESSSESSSRERSSEEEESEE
          *|*           *|*                     ***                     ***       ***  *|****                          *****           |        --SSRSSESEEESREEESSEESSSEEEEEESESESSESESSSEESEESEESSEEEEREEESESSSSEEESSESEESESSEEEESESSESSSSEESEEEEEEEESEEEESEESSESESSEEEESSSSEERSSEEEEESSEEERRSESESEEESESESSESEERRSESSEERSEREEEEESEEESESSEEESEEESSSEEEERRSSSESSSSSESRSEEEEEEESSSESEESSSESEEEEEEESESEEESEREEEESE
          *|*      ***  *|*                     *|*                     *|*       *|*  *|**|*                      *** *|*|*          --     ---EEEEEEEEEESSESERSSESESESSSEEESRESESSSEERSSESEESEEEESEEEEESEESSESSESEESSSESSEESSEEESSSESEEEEEESEEESESEESESESSESSESSEEESSSESREEEESEESSSEEEEEESSREEESESEESSSESSSSEEESESRSERSEERESSESESSEESSEESSSESSESESSSSSEEREESESESESEEERSSEEESESSEEEREESEEESESESEREESEERESSSEESE
      *   *|*      *|*   |                      *|*                     *|*   *** *|*  *|**|*                      *|* *|*|*      -- -EE-----ESSSESSEESEESEEEESEESESSSSESESEEEESRSEEEEEESESSREESEEEEESSSESEEESESSESSSEESEESESSEEESEEEEESESSSESEESEESSEEEEESEREEEESESSSSESSEEEESEEEEEESESESSEEEESRESSSSEESESSEEEESEEEEESSSEEESESEEEEESSEEEEEESSEEESESSSESEESSEEESRSSSSEESSEEESSEEEEESESRSESEESESEEEESEEEEEEESEEES
      *|* *|*      *|*   |                      *|*                     *|*   *|*  |   *|**|*                      *|* *|*|*   ---EE-SSESSESSEEEESESEEESEESERSEESSSSESSSEESEESERSESESEEEESESEEEEESSESSSREEEEERRSSSEESESSSSSSEESESESESSSSEEESEESESESSSESEEESRESEESESSSEEEESESRSEEESEEEEESESEERSSEESEESESEEEERSSESESRSSEESEEEREEEESEEEESEESERESEEEEESSESSEEEESRSEEEESEEESSEESSSSEESSEEEESEEEESESEREESEESEEESESREEE
      *|*  |        |    -                 -    *|****                  *|*   *|*  |    |  |  -                    *|* *|*|   -EEEESEESEEESSESSSSEEREESEEEEESSSESEESSEESEERERREESEEESERSSSEESSSEESESESEESESREEEEESESSESEEEEEEEEEERSEEERSSSEESEESSEESESEESSSESEEEEESSSSESSSSSESEEESEERSRSESSEEEEESSESEESEEEEREESSSEESSSREESEERESESSSESESSSSEESRSEEESESRESSSSSEEERSEEESEESEESEEEEEESESSESEEESESSSEESSEEESEREESSSSE
       |  -|   ---  | ---E-         ----  -S---  | *|*                  *|*   *|*  -    |--|--S-             -      |   | |---EESSEEEEEEESESESESEESESESSEEESEESREESERRESSEEESSSESEESESESEEESEEEESEESRSEEEEESEESEEEESEESEESSEESSESSERSESSSESEESESSEEEEESSEERSEEEEERSSSEESEESEESSSRESSSRREESEEEEEEEEESSSEEESEESEESSESEREESSSSSSSSREESESEESESSESSESSSESSSEEESESEEESEEEEEESSESSEEESEEEESEEESEEEERESEEEERESESSESESSES
       |--E----SEE- --EESER----    -SSRE--SEESS- | *|*                   |     |  -S--- -ES-SSSR---  -   ----E--    |---|--SREREEEESESSSSEEEEESESEEESSSEESEEEEEEEEESEESESESEESESEEEEESEESREEEESESEREEEESSESSESSSSEEEEESEEESEEEEESSEESSESESSSREEESSSESESSEEESESSEESESRREERESESESSSEESEESSSESEEEESSRSEEEESESSSESSSEESREESESSSRSSSSESEEESSSSSEEESSREESEESESSEEEEEREESREESESSEEESEESSSEEEEESSSSSEESSSRESSRSESESREEES
       -ERSSSSESSRE-EESESEESEEE-- -RERSSEEEESSEE--  |    -               |--- -|--SSRES-ESSRSSEEESE--E---EEESESS-----SSS-ESSERSEERSSSERESSESESSESSESSSSESEESERESERESEESSESSESEEEEEEESSESSSRERESESESEESERRREERESSSSESEESEESSSREEEEREESSESEESEEEEEEERSEESSESESERSESEESESSSERSRESEESEEEEEESSESEEESSSSSSSESSEEESEEEEEEESREESESSEEESEESESSESSESEERESSESESESSESESEEEEESSSSEESSESESESEEESSREEEERSEEESSEESESEEESEESSSEES
 --  --ESSSERSESEEEESESERSSRSRERS-ESEESESESSESSESS--|   -E---      --   --SSS-E-SEESEESESESEESSSSESSSSEESEESSEESSEEERSSSESEESESSERESEEESSESERESSSEESSESESESSSSSEREEESSESRSESESSSSESSESSESEEESESESESEERREEESSSSESEEESSESEEESESEEESESRSRSSESSSSSERSEESEEEESSSSEESEREEEEESESSESRERESSSEEEEESSESEEESSEESSEEEERSESESSESEESEESEEESSSEERSEESRREERREEESSSSESEESERESSESSSSEESSESSESESSEESSSESESEESEEEEREESEEEEESSEESEESSE
-EE--SSSSSSRSSSEESESSESESSSESSEEEREEESEEESRSSSESEESE----EESSE- ----EE---EESEEESSREESSEEESESESEESRSSEESESSSESSRESESSRESSSSEESSEESERSEEEESERSSSESSESSESRSSEEEEESSEESEEESSERESESESRESESSEEESSEEESEEESESESESSSEESESSESSSESSSEESSSSRESESEEESESSEESEREEESERSEESESEEESRSESESSESSEEESSSEEEEERSSSEEEESERESSSERSEEEESEESESEESESSERRSSSESSEEESSSESESREESSESSSRESRESSEESRSESEESESSEESERESEESSEEEESSSSEESESESEESSSSSSESEESEES
SSEESSSSSSEESESESEESSSESSESSESEEESEESEEESSEERSSESEEEEESESSSESE-EEREESERSSEEEESSEESESESSSREESSESESEEESRESEEESSEESESESSRRSSSSEESESESEEESSSSESSSSESSESESSRSESSESESSERRSSESESEEEEESEEESSESESSSSEEEEESEEESEEESRESESESESSSSSEEESEESRSRSESEESRSRSEEEESEESESSESEEESSESSEEESSSSRESSESEESESSESSESEEEESSSSRSESESSSSSESEEESSSSEEESSEEESESSEEESEESSEEEESEEESSESSEESSEERSESSSEESESEESSESSESSSEESSEESESEEEEEREEESESSEEESREEESEE
ESSEEEESESSRSSSSESRSESESESEERSEEEEESESSSREEESSSESESRSSERESSSSEESRSSESEEEEEEEESSSSEEEESEESEESSSEESSSSSRSSSESSEEESRESESESESSSSSSESSEESSSEESEEEEESEEEESSSEESERSSSEESEESRSSSERERESSSESEEEEESEEEESESEESESESRSSESESESSESSESSSSESEEEEESRSEEEEERSEESEEESERRSSEESESEEEESEEESSSSERESSSEESSESEEESEESSEEESSEESEEEEEESEEESEEEESSSESSEESSSSSSSSSESSEEEESSSSSESSEESRSSESRERERSEESEEESEESEESEESSSSSESEESSEEERESEEESSSESSESSESSES
SERSESSSEERSEESSEEESRSSEEEEESSSSSEEEEEEESSEESSESESESESRSSSEESESRESSEESSSSSEEEEESSSESESSSESREEEESESSESEESEESSSEERSSEERSERSREEESEEESSEESESREESSESSSESSEESEEEEESSSEESSESSESSEEEEESEESEEEESEESSESSSERSEEESEESESREESSSEESEEESEEEEESREEESEESSESESESSSESEESSESESRSSEESRSSEEESESESSEESSEEESREEEEESSSSSRSSSESSESEESEESESESREREEESEEESRSEESSEESRSESESERSRSESSEEESESESRSSSRSSRSEEESSSERESEEEEESSSESERSSSEEESSESSEEEEESSEEES
EERSESSSSSSSEESEEEESSEEEEEESSESRRSERSSEESEESSESSSESSESEESSESSRESEEESSEESSSSEERESEEEEEESEEEEESSSESERESESSSSSRSEEEESEEESSSESSEEESESESSEESSSESESEESSESSSEREESSSEEEEESSSSSSESESEESEESESEEESSREEEESSREERSSEEESESSEESESSEEEEERESESESSSSRSESSSEESEEEEESRESSEERSSEESEESRESERESEESSSRSESSRESESESRSSESEESEESEESESESSSSSSSEEESEESEERSESSSSEEREESESEERSEEESSESSESESSSESERESSESESESSSSESEEEEESSESSREESEEEEEEEEEESESEESRESEESS
ERSSESSSEESESSSESSREREESEESSEESSSESSEESSESSESSSSEESSSSSSSSSSEESEESSEEERSSESSSEESESSEESESSSEERSEEESSSEESSESSSSESSRSSRSSRRESSRSEEEEESESESESEEEESSSESSSESEESSSSEESSESEEEEEEESSRSEREESSSERSSRSSSSESSESSRSRSESESEEEESEESEEEEESSSSEESESESEERSESSEEESSSSSESEESSEERSSEESESEEESESSREESESESEESSSSEEEESRSESESSSSSESESEESSEESRSSESSSESSESSSSSSERESSSESSREESSSSESSRSSEESSEEESSESESSEESSESEESEEESSEEESSEESSSSSRESSSSSSSSSESEER
ESESSESSESEESSEESSSERESSSSSEESESESESESEESESESSSEEEEESESSSSSERSSEEESEESESEEESSSEESESSESESSSEESESSEEESESEEESSRSEESRSEESRESEESRSEESSSEEESSEESSSEESESEEESSESESSRSSSSSSSEREEESREEEESESRESSEREESSESSSESEESESESSSEEESSSEEESSERESESSSESEESESSSREEEEEESESERSRSERSSSSEESEEESSSSEEEREESRSEESSEEEEESSESRSESEERRSEESESESSSSSSERSRSESEESSESESSESEEESSESEESEESSSERESESEESESSESERRSSERRSREEEESSSEEEEEEEESEESRESSSSSSSESSSSESRSES
SESSSESESEESSSSRSESSRSESSESEEEESSSSESSSSSESRSSESSESEESSESESSSERSESSRSEEESSESSESEERSEEESEERSEESESESSESRSREESSESEESESRESSEESSSERSSSSSSSESSSSSESSSSSESEESSSSSSSREREESEESSSEERSSSESSSSEERESEESEESSEESSSERESSSESESESSREESESSSSSESREEESSSESESESSSSSSEESSREERSSESSRSEERSSSEEREEESEEEREEEESEERESEEESEESSSSESESSSEESSSEESESEESSEEESSSSSSEERSEESSEESRSEEEERSRSESSESSEESSSEEESSSSSSSEESESSSERSSSEESRSESEEEESEESSRSERESEESRE
ESEESSSSSREESSSEERSEEEEEEEESERSESSESESRSESSESSSSESSSEESSSEESESSSESREESEESSSSSSREEEEEEESESESEEESSESEERSSEEESSSSSEESRESSSEESESSSSSSSSEEESEESSSRSSESSSEESSEESSSSSSSSSEEESEEEEEESSSESSESSERSESSEEEESSEEEEESSESSESSSESEEESSSESSRESSSESEESSSEESREEEESESESESEESSSEERESEEREEESSSEESSSESESSSESESEEEEEREEREESSSSESEESSSERESSREESEEEREESSSSESSESESSSESEESSESEEESESSRESEESRESSSESSESEESSSESESSSRSESESEESSEESEERRESESEESSEESS
SSSRSESESESSEESSSSEEESESEEESRRSSSESREERSSRESEESSSSSESSSSESSEESSESSEEESSSEERSESSSSSSSEESSESSSSEESEESRSEEEESSSSEEESRESSRRESEESSSSESSSSSESESESSSSESSESESESSERSESSEEEESSESSSEEEREESSSESSSSSEREESESSESSEEEEEEESESSREESSSSSESSRSEEEREERSESSESSSSEESSSEEERSRSSEESSEEESESESEESSESEESSRESSSSESESEESSESSESEESSSSESEEESREEEESSEEESRESEESERSESEEESESEEEESSRSSESEEESEEEESSSESESESESESSSSRSERSSERESEESERSSESSESSESRSESESESSSSR
ESSSSSEESESESREESEESEESESSSESSSSESSSESSSSEEESEESEERRERESESESSSSEERSSSESESEESSSEEESSEESEEERSEESSEESERSSESSSRSSRSSESEESSSEEESSSESSSSERESEESESSSRESSSESREESEREESRESERSSRSSERSEESEEESESEESESRSSESESSSESSERSSEESESSESSSESSSESEESEESSEREESEEESEEESESSSEESRSEREESREERSESREEESERESRSESEEESSSSSSRSESSESSESSSEESSSRSSSRSEEESESESSESEESEESSSRRESSSESESESESSSSSESREESSSESEESEESEESSSESSSSESEEESESSSESESSESSESERRSSSESEESSSSE
SSSSEESSSREEESESRSESRSEEEEESESESSESSSSSSEESSSSSSSSERSSEESEERSSSESESSERSSESESESSEEESRSSRSEERSSERERSSSEESEEERSESSEEESESESESESSSSSSERSSSRSSSSESESSRSRRSSEEERSESSEESSSSSESEESSSSESEESESEEESEEESEESEREERSSEEEESSEESESSSERERESSEESEESSESSRSERREEERSSSSSESESEESSSESRSESSSESESESESERESSESRSEESESEEEEEESSEEEEESERSSEEEESEESSEESESSESEEESSESSEEEEESEEESSSSESSSSSSSESSSESSSRSSSSSESSSEESSESSSSRESEEESEERSESSSSRSEESESSSERSS
SSESSRSEESESSSSEEEESSEEESSESEEESESSEESSEESSSSSERESESSEESSESSSSESSESSEERSESEESSSSESESEESEEEESSSSSRSSESESEESESSESEESESSSSRSSEEERSESSESRERSEESSSSSSSERSESSESSREESSESSSRSEEESSESSSEEESSSEESEEEEEESSESSSESSSSSEESSESSRSREEEEEESSSSSSESSEEESESEEESEEESSSSSSESEEESESESESSESRESSESSSSSSRSSSESEEESESSSSESEESSSSEEEESESSSSSESRSRSEEESSSESSESESSSRESEESSREEESSSREEESREESESSESSESEESSESSSSESESEEESSESSSSESSRSSEESEESSREESEES
ESERSERSEEEESESSESESSEEEEEESSSEEESRSSSEESESSRESSESEESSEESESESSEESSSSEEREESSSRESESSSEESSSSSSSREESREESSEESSEESESSSSSESSSSESSESRSSSSESSESSEESSSERSSESSSERSSESEREESSSSESSERSSREESEEESSERESSSSESSSESSEESSRESSESSSEEEESSEESEESESEEESERESESSSSSESSEEESESREESEEEEEEEEESEEESSESRESRRESREESSEESEEEEESESSSSESESESSEEESEEESSESESSEEEEEREESRESSERSEEESRSSSEESSERESEESSRSSESSREEESESEEESSSRERESSESSSSSSRSESSSESESESESEESSSSESE
EESRSSSESSSESSSSEESEESESESSRSSRESESESEESEEESSSESSEEREESSSSSSSEESSSRESSRSSSSSSESSSSSEEEEESRSSEESESESEEEESRSREEEESSEERRESESEEERESESEESESSESESSSSSSESSESESSESSEEESESSSEESSEESERSSEREREESSESEESESEESESSESEEESRSESSRRSESSSSESESSSESSRSESSSERSESSEEREESESESSSESESESEERSSRSESSSSSSSSSSSESESEESSSSSESESEEESESSSEEESSERRSEESSEESRSSSEESSEESSSESEESRRSSSSSSESERSEEEEESEESSEERSESSERSESSEESESSSESESSEEESSEREEEESEESEESEESSS
ESSSESSSRSSSSSRESEEESSESSESSSSSESEEESSEESEESERESERSRSSSESESSSESESESSESESSSESSSSSESSSSSSESSSESSSEEEERSSESSSSSEEEEESSESEESEESEESESSSSSEESSSSSSSSSSESSEESSSSSEESSESESSSSSSSRESEESRSSSESEESSSSREESSESRSRSSSSESSSSRESESSRSSEESESEESSSESSRSSSSSSSSESSESSSEESREESSEESEEESEEESSSEESSSEEEESSRSSESESSREEESESERSSSEESERSREERSESESESSSSSSEESSREEESSEEESERSSRSSSSSESSEESERESSEEESEEEEEEEESSEESSESSSESEEESEEESSSEESSSESSSEESSS
SESEESERSESEEESSSRSSSSSERRSSESSEESSSSRSEESSEESSSSSSSESESEEEEERSESSSESSSESEEESESEEESEEESSSSEERESSEEESSESESESSEEEESSSSEESSESEESEEESEESEEEESESSSSEEEERSSSSEESRSESSSSESEESESSRSSSEESSSSSSRSESSSEERSEESSEESESSSRSESSSSSRSEEESRSESESESSESESESRSEEEESEESSSEEESSESSSEEESESESSSESSSSSESSSESESEESSESEESSEESSEESSSSEEEERRSSEEESEESEESESSSEESSSEEESEEESSSRESSESRESREESESSSERESESESESERSSESESRSESSESSESEEESSERRSSESSSRSEESSSS
EESSSSEEESSSSESSSSSESSSSSESESESSSESSESESEESSEEEERESEEEESSESEEESESEERSSRSSESESRERESSSESESESRESSSSSEREESSSSSSESSESESSESSSSSSSERSESSESSSSRSSESESEEESSESSSSESSSEESSESEREREEEERSESSESESSEESSSESEEESSEESSSESSSSESEESESEREEREEESRREEESRSSSESESSSRSSSSSRRSSESSSSEEESSSRRSEEEESSSSSESSESEEEESESESESESEEESESEESESESSEEESRSSSESESSRESRSSEESSSEREERSSSESESSSREEESSEEESSSRSESESSESSSSSSSEESSSESESSSSSSRSSSSSESSSSESSRESSESESS
SEESSESSESSSEESSSSSESSSSSRSERRSSEESSSEEESESSSSSEEEESSSESRSESESSESSSSSSSSSEESSSSSSSSSEERESEESEEESESEEEEEEEESRSSEEEERESSSERSSESSEEERERSRESSSEESESSEESSSSSSSSEEESRSSSSESSSSSRSESESSSSESRSESRSESESERERSSESSESSSESSSSSSESSSEEESSSSESRSEEESESESSSEESSSSSRSESESSSSSRRSRREEESSESSEEREESSSERSSSSESRSSSSEEESSSSEEREREREEESSSESEESSSESESESSSSSESESEEEERRSESSSSSEESSSSESSSSRSSSSRERESEESSSESSSEEESSSSEESSRRESSSSERRSSESSSESE
ESSEEESSRSSSESESSEEEESSSSSSEESESSEERSESSSSSSSSEEESSSSESEESSESEEESSRESEEEESESESSSESSESSESSSEERSSESSESSESSSESSESEESESSESRESSESSSESSESESESSEEESSERSSSSESESESSESESESSESSSESSRESSRSSSRESSESSSSSSESSSSSESSRSESESSESESSSSESEESSSSSESSSSSESSSSSSSESEEEEESSESSERSSSSSSSESRSSREESSSEREEESSRSSSESESSESSESSESSSESEEEESRSEESEESSSSSESSESESSRESSSSESSEESSEEEESESSESESSEEESSSERESESSSESEEESREEESERSRSSRESEEESSSESSSSESESSERSEES
