                                                                                                                               *|*                           *|*                                                                                                                                   *|*      
                                                                                                                               *|*                           *|*                                                                                     *|*                                     *|*   *|*      
                                                                                                                               *|*                           *|*  *|**|*                                                                             *|*                                     *|*   *|*      
                                                                                                                               *|*             *|*           *|*  *|**|*                                                                             *|*      *|*           *|*              *|*  *||*      
                                                                                            *|*              -    --|*         *|* - --    -   *|*-           -   *|**|*                                             -     -     -     -             *|*      *|**|*        *|*     -  -    - -   *|--      
                                                                                            *|*    *|*   -  - ---- *|* ---    ----- -  ----     -- ----------- -- *|**|*                  *|*                       - -- -- --  - --  -          -  -*|*      *|**|*        *|--- -- -- ---- - --- -     -  
                                                                                            *|*    *|*  - --        ---   ----              ----                 --|**|*               *|**|*                      -    -     --    --  --      - -- -|*     *||**|*         -   -                -   - - --
                                                                                            *|*     -- -                                                           -- --        *|*    *|**|* -          -        -                       -- - -      ---    *||**|*       --                          -    
                                                                                            *|-- ---  -                                                              -  - -     *|*    *|**|-- - ----- -- -      -                          - -          -   *||**|*      -                                 
|*                                                      *|*            *|*              ------  -                                                                        - --   *|*  --*|* -    -     -    - ----                                         ----|--*|-------                                 *
|*                                                      *|*            *|*       *|*   -                                                                                     --- - --  -|--                 -                                                 -  --                                        *
|*                                                      *|**|*      -- -|*    -  *|----                                                                                         - -     -                                                                                                                  *
|--                                                     *|**|*   ---  - --   - ----                                                                                                                                                                                                                        *
-  --                                                   *|**|*  -         ---                                                                                                                                                                                                                               
     -                                                 --|--|*--                                                                                                                                                                                                                                            
      --                                              -  -  --                                                                                                                                                                                                                                              
        ------ *|*                                   -                                                                                                                                                                                                                                                      
              --|*                  ----   --     ---                                                                                                                                                                                                                                                       
                --          *|*    -    ---  --  -                                                                                                                                                                                                                                                          
                  --        *|* ---            --                                                                                                                                                                                                                                                           
                    -       *|*-                                                                                                                                                                                                                                                                            
                     ---    *|-                                                                                                                                                                                                                                                                             
                        ---  -                                                                                                                                                                                                                                                                              
                           --                                                                                                                                                                                                                                                                               
                                                                                                                                                                                                                                                                                                            
                                                                                                                                                                                                                                                                                                            
                                                                                                                                                                                                                                                                                                            
                                                                                                                                                                                                                                                                                                            
                                                                                                                                                                                                                                                                                                            
                                                                                                                                                                                                                                                                                                   *|*      
--------------------------------------------------------------------------------------------------------------------------------|-------------------------------------------------------------------------------------------------------------------------------------------------------------------|-------
