                                                                                                                                                                                 ***|*                                                              ***            *|*                             ***    ***      *|*                                                   ***          *|*  *|*             *|*  
                                                                                                                                                                             *** *|*|*                             ***                              *|*            *|*                   ***       *|* ****|*      *|*    ***                  ***                       *|*          *|*  *|*             *|*  
                                                                                                                                                                             *|* *|*|*                             *|*                       ***    *|*            *|**                  *|*       *|* *|**|*      *|* ****|*                  *|*                       *|*      *****|*  *|****          *|*  
                                                                                                                                                                             *|***|*|*                             *|*                       *|***  *|*            *||*                  *|*       *|* *|**|*      *|* *|**|*                  *|*                       *|*      *|*|*|*  *|**|*          *|*  
                                                                                                                                                            ***              *|**||*|                              *|*                       *|*|*  *|*             ||*                   |        *|* *|* |        |  *|**|*                   |                         |       *|*|*|   *|**|*           |   
                                                                                                                                                            *|*               | *|| |                               |                         |*|*  *|*             ||                    |         |  *|* |        |  *|**|*                   |                         |        |*|*|    | *|*           |   
                                                                                                                                                            *|*               | -|| -  -  --    -      -     --     |   -- --   - -    - -    | |    |            ---| - --- -     -   -  -  - -  --|  -|---    -- --   |  |---  --  ---        --- -  --   - -  -    --  ----   - | |-- - -|--|-    -      -   
                                                                                                                                   ***         ***          *|*              ---S|--E--S--RR--- E--  --E- ---ES--- -----ES-ES-  E-S----S-S--- --|  - | --  ------ EES--E-SEE-S-----E-- E--S -S E--SS---E|EES ---ES-EE---|--|SES--EE- EES- ------EEE-E--RS---S-E--E----RE- SESE - S-- |EE-E R-SS|R--  E------E --
                                                                                                                                   *|*         *|*       ****|*              SSEE-EESEEESESSSRS-SES--ESSE-SSSSEEER-EEESSEEEEEE--SSEEEESESREEE-ES---E---SS--ESRSEE-ESESSSEESEESSERSSSES-SSEE-EE-ESEESSSSE-EEE-SESESEEESSS-EE-SESEESSE-SSSE-SEEESEEESESEEESESEERESESRSESSEE-SREE-S-ESR--ESES-ESSS-SES--SSSEESEE-ES
                                                                                                                                   *|*         *|*       *|*||*             -ESESESSESESEEESEEEEESSSEESEEEESSEEEESSEEESEESSSSSREESEESSSEEEEESEEEEEEESEEEEEEEEESEREEEREERSSEESSEEESESEEESEEEESESEESESSERSERSEEEEESESEEESEEESSSSSESSSESEEEEEEEEESEEEEEEEESRSEEERSEEEEEEESEEESEESEEEESEEEESESRSESRESEESSEEEESSRESEE
                                                                                                                ***                *|*         *|*       *|*||             -EEESERSRSERRESESSSSSSSSRSESSEEREEESESEESSEESEESEEREESERSESESSEESREEESESSSEEESSSSEESSEEEEEEEERRESSEESRSEEEESRERSEEEREESSSESEEESRESREESESSSEESSSESESSESRESERSSEEESERESSEESEEESESEESEESRREESEEREEEEEESSEEESSSEEEESEEEEEESREREEEESEEESSS
                                                                                                             ****|*                *|*         *|*       *|*||---- -- -- --SSESEEEEEESEESSSEESSESEEESESSESEEEEERSEEESSEESSEESSEEESSSSESEEESESSSSEEESSEREEEESSEREEEEREEEEERSRSRERRESEESSEEEESSEEEEEEEESESEESSESSSSESESSSEEESEEEEEESESEESESESSEESEEESESESSSEEEESSEEEEEEEEESEESSEEERSERSEEEEESRSEESEESEESEEEESSESEE
                                                                                                             *|**|*            *** *|*         *|*       *|*|-SEEE-EE-SS-EESESEEESSEERRESSSESSSEESEESSESESREEEEEEESESSEESSSSSESSESEEESEEREEEESESSSEERSSEESESEEEESEESEEEEEEEEERRSEESSEESRSSEESEEESERRRSSESSESSSESESESSEESSESESSSSEESEESSSSESEEERSERESSEEEEEESSRRSESESSEERSSEEEESSEREEESEEERSSESRERSEESSEEEESSSESR
                                                                                                             *|**|*            *|*  |           |    ---- | -SSESSSEESEEEESSSEEEEEEESESSESEESSEEEESSEEEEESSEEEESERREEESEESEEERSSEEEEESEEREESSEEEEESESESESEEESEEREEESEEEEESEEESSSEESEEEEEREESESSSEESSSESESEEESEEEESESSEESSESSRESSSSEEESSSESSEEEEESSESSSERSSESEESSSEREEEESEEESESSEEREEEEEESEEEEEESSEESEESERSESSSSS
                                                                                               ***       *** *|**|*            *|* -|         --|----SERE-|-SSSESSSRESERSESESRESSSESREESSEEESSEERSEEEEERSEEEEESEEEEESESESSESESEESRESESSSSESEESEESSEEERSEESSESEESSESSESSEEEEEESSSSEEEEEEEEESESREERSESSEESESESSSEEESEEESEEEESSEESEEREESSSEESERERSESESSEEERESSEEESSEESSRESEEESSEEREEEEESESEESSREEESEEEESSEEEEESEESS
                                                                                               *|*     ***|* *|* |              | -E-        -ES-SSEEEESES-SSESSSSESSEEEESSSSSSEEEEEEESEESESEEEEEEESEEEESSSSSESESESRESSESESSSEEESESSSSESEEEESESESSESERSSRSSSSSEEESSESRSSEEESSSSSESESESEESEESEEESESESSEEESESSEESSSSRESSEEESEESEESSESEESESEESESEEERRESESSRRSRSEESSSESESEESEEEREESSESESESSSEEESSEEEESSREEEEESEESESR
                                                                       ***                     *|*     *|*|* *|* |              |-SES-  -----EESSSSSSSSSSESEESEEEEEEEESERESESSEESESEEEEEESSSSEEESSEESSEEEEESSSSESSESSSSSEEESSRESSSSSEESSSESESESESRESSSERSEEESSRSEERSSEEESEESESSSEEEEESEESSEEEESESESSSRSSSSEEEERSEESSSEESSESESSESSEESEEESEEESSESEEEREESSESERREEEEEESERSSEEEESESESEEESESEEEESEREESEESSREEESEESEESE
                                                                       *|*   ***                |      *|*|*  |  --             -SESSS--ESSRSESSSSEEEEEEESEEEESSESSEEESESEEESEEESSSESEESESSRESEESESEESSSEESEEEEESSREEEEESSEEEEREEEEEESEESEESEESEESEEESESSSSEEESSESRSESEREESSSRSESSEEEESRSSRESESSSEEEREEEEESSESEESEEESSEESEEESESEEESEESESSSSSSSEERESEESSESEEESSEEEREEESSEEEESESSSEEESSESEESSESEEESSSEESESESSSESSS
                                                                   *** *|*   *|* ***            |       |*|*  | -SE-  -      ---EEEEEEREESSSESRSSEEEESESSEEREESESSESEESEESSESESSSESSSRSESSSSEEEEEESEEEEEEESEEEEEESEEEESESESSSSESREEEESSEESSEEESESSEESSESESESSSESSSSSEEESSEEESEEESEEEESSSEEESSSEEESEEEESSSESSSSSSEEESSEERSESRESESSSESSESRSSEEESSSESESSSESESSEEEEESEEEEESEESESEEESRSSEEEESSESEEESEEEEEEEEEEEEEEESE
                                                         ***       *|* *|*   *|* *|*            ---     | |  ---RSEE--S-    -SSSEESESSEEEEESEEEESRRESEREESESEEEESSSEESSSEESEERSSEEESREESESEERESSEESSEESSSREEESSSEESSEEEESSSEEESSEESSEESSSSESESSESEESERSEEEEESSSSSEEEESSSEESSSESESESESSERSESSESSSREEESESSESEEEEESESEESSSEEESSESSEEEEERSSESSSEREEEEESSESSSSSSSEEEEESSSEESSEEEESSSEESEEEEEESESESEESEEEESEESEESESSES
                                                         *|*       *|* *|*   *|* *|*           -EES-- - --| -EEEESESSESS-- -SSSESSSSSEEEEEEEESRERRSSEEEERSSEESESEEEEEEESESEEEEEEERESSSSESSEEEEESSSESSESESESSSSESEREEEESESSEERRSEEEEEESEESSEEESESEESESSEEESSEESESEEESSEEEESSEESESEESSSEEEERSSERRSSEEESEESEEESSEEESSSEEESSSEEEESSEEESSESESEERESESESSESESSRSESEEEEESSEEEEESEEESEREESEESSRSSSSEEESESSSESEESEESSSSSSS
                                                         *|*      **|* *|*   *|*  |    -   ----SESRSE-E-SS--ESESSESEEESSSS-EESSESEESESEESEEESESESEESSESESESESEEREEEEESSEEESEEESESESSSEESSRSSEESEREESSREESESSESESEERSSEESESSESESSSEERESESSEESSRSRSSESERRESEEESEEESEESEESEEESEESERSRSEEESESSEERSRSSEEESEESSSSRSESRRSEERSSEEEESSESESRSSEEERSESEESRSSSSREEEESSSSEESESSERSESRSESSEESEESSEEEEERESSSESSEEESRESSSSEESESE
                                                         *|*      *||*  | -   |   |   -S---EESSERESESEEESEREESESSEEESESSESEEESESESRESSEESSSEEEEESEESSEESSSSESEEEESESEESEREEESEEESSSSSSSEESSESSSESEREESSREEESSSEESESRSSEEEESSEEEEESEEESRSESEEEEESSESEEEEEEEEESERESEEEEEEESSESESSREESSRSSSSSESERESSEEESSSSESESSESSSESRSSSEEEESEESESESSSEEEEEEESSEESSSSSRESREESSESSEEESEEEESSEEEEEEEESESSEESERSEERESSESESESEERRESSS
                                                          |       *||*  |-S- -|  -----ESSEEEEESESSEESESRRSESSSESSEESEESESSSSREERSREEEESEREEESSEERREESSESESREESSEESSEEEREESSRSESSEESEERSSSSSEESSSSSSESSSESSSSESEESSEESESSSESESESEESESSEERESSEESSEEEEEESESESESSSSEESESEEERESERSESEESSESESRSESESESEESESESRSRESSEEESSSESEESSEEESEESEESEREESESSEEEEEEESREREEESEEEESESRESEESEESSEEEESSREEESESSESSERREESSSSESSEESRESREE
                                                        --|       *||   -ESE-S---SESSSESSESEEEEESEEESEESSEEEESRSEESEERERSESEESRESSSSEEESSESESSSSEESESESEESESESESESREEEESRESSESSESESESESESSESSSSSESEREEEESESEESEERRESEESSESSSEESESSESSEESEESSEESSSSSEEESSESSSREESSSESEEEESSESEEESEESSSSSESEEESEESEEESSEEESSEEEREREREREEEEEESSEEESSRSERERSEESSESSEEESSSSERSSESSSSEESSEEESRSRSEEEESSSRSERSEEEEREEESESESSESEEESEESSE
                                                       -ES--- ---- ||---SSSESESSSSESSESEESEEEESESSESEEEEESSESSESSESSSEESEEESSSSREEEEESSESESSESEESSSSSESSSSRSSSEESSSEEESERSESSEESEESEEEEESRESEERSSSRESSSSSSESSSSESSEESSESESESRSEEESSSEEERSSREESESSSSEESEEESEESESEEEEEEESSEESESEEEEEEESSESESSESESSSRSESEESSESSERSRSESSSSEERREEESESSESEESSRSREESSSESESEEESEEESEESSEESESSSREEEREEEEERSSESSSESRSESESESSEEESESSESESSEE
                                                      -EESSES-EEEE-|-SRESSSSESSESSEESESSSESSESESESEESSSESESRSSEESESSEESSSSEEEESEESESSESSRESSEESESEERESEEEERSSESESSERRESEEEESEEESSESSESSRSESSEEERSRSSSRESRESSESSEESEEEERSEESSEESSEESSSEEEESSEEEEESEEESSEESSSEEESEEEEESEERSSSRESSSSSEESSSSSSRSSSEESRERERESEESERSESESSSSESSSESEEESESESSSERRSSSSSESESSRSESEEESSSESSREESEEESSEEESEEESSEESSEEESEEESSEESSSSESSSSESSRSSS
                  ****                              --RESSSSESRSESS-EEESEEEEEEEEREERSEEESSSESESRESSESSSSSSSSESSERSESSESSSEESSSEEEESSSSSESESSEESESSESSSESSERESSESRSSRSSEESEEESSESSSSSSESSEESEERRSSSSSSSERESESSESEEEEEEEESESRSESEESSSRSEEESSEEESSSSSERSESSSEEERSEERSEEESESEEEESSSEEESSEEESSSSEESESSSEESEEESESERESSSRSEESSSESESEESSSSEEESSESSSEESESRSSESSSESEESSEEESESSESESSEESSSESSESSESSSSRSREEEESESEESSSSRSEESEE
                  *||*                          ----SSEEESRESSSSSSESESSSSESEESREESSEEEEESEEEEESSSSEERSSEEEESSESSSESEESRSSSSERESSRSESRRSESEESEESSSEEEEERSSSSEERSSEESESEESSSEEESSEEERESEEERSSSSESEESEEESESRSSSEERESSSSESEEESESEESSSSERESEESESSSSSESSSSSSEESSESESRRSSESSESSEESSESSEEEEREEESSSESSSSESESSSESRESESSSSESSESESSSSESESESRSSSSSSEEESESEEEEESSSEESEESEEESSSERESSERSESEESESSSESESESSSSERSSEESSSESSEESSSREESS
                  *||*         -   -       -   -SSSEEEESEESSESSSEEEERSESSESEESSESEESSESESSEEESESSSEESSESEEESESSESSSSEERESEESSSSSSERSESESSSRSESSEEESESESSSSESSSSRSSSEESSSSEEESRSSSESSEEESSESSSSEESSEESSESEESSSEEEESESSEEEESERSESSESSEESSSEERESESRSSSSSESSEESEESESRSSEESSESEESSSSEESESSSSSSSEESRSEEEESSEERSSRSESSSSSREESSSSSSEESSSSESSSEESESSESEESESSESSEESSEEESSSSEEESEEESSSSRSSREESEEESESSESESERSEESEEESEEEERSSE
                   ||        --R---S-------E---EESREESSSESSSSSESSSRRESEESEEESESESSSESSESERESEEESSSESSSSESSRSEESSSSSSSESEEEESSSEEESESSEESSSSRRSSEESEERRSSSESREESSSSESEESSEESEESESSSERSESSESSSEEESESSRESEEEEESESEEEEESEEESSSSEEESSSSEEEEESSSEEEESEESRSESEERESSSESEESESSSSEEESESESRESEESEEEEESSSEESSEESRESSSSESESESSESESSESRREESEEEESSEESSESSSESRSSEEEESESSSSEERSEESSERESSRESSSEESESESESSSSESRERSSSEESESSREESESSSES
                  -||  ---  -EEEEEEESESSSERSSSSSESSRREESESSESRSESSSSSEEESSSESESSSSEEEEEESSESEEEEEESESSESSSSSSSESSSSSEESERESESSSESEEESRSSSSEERSSEESSEESREERSESSERSESSSSEESESSSSSSEEERESSEEESSSSSESREEEESEEESSEEEEEESRSESSESEESSESESSESESSSESRSERSESREEESSESSRSREREEEREESSEEESSEESSEEESSSSESSSESESESEEESSEEESESSSSERSSEESSESSSEESSSESEESSESESSSSSSSSSSSESRSSERESSSSERSREEESSSSSEESEEEESSSSSSSESSSEEEEESSRRSSSESESS
---          --- -E-- -SES--SRRSSSSSEEEESESRSSSSESEEERSSSSSESSSSEEEESSSSESSERESESSSSESSSRSSSSEESSSESEEEEERSSSSESEESESSREESSSEESSSSESSESSESEESSESESSSESESSSEEESEESEESEEESESSEESESESSSSSEESEESESERESEEEESSSESSEESSSEESESESREEEESSEEESESSSSSESSSESEERSSRSESSRSSRESSSSESEEESRESSESSEERSEERSESESSSSSESSESESSESSSRRESSEEEEEESSSSEEESEESESSERESEERRSRSSSSESSESEERSESEESSEEEEEREEESSEEEEEERSEESEESESESSSSSSSESSSSSSSRESE
SSE--  ------SSE-RSSS-EREEEEESEEESSSSESEESSSSERRESEEESSSESERRSSESSESSESRSSSEESSSESESSRESERSEESESEESSSSERESSERSSESSESSEERESSESESSESSRSSSSSSEEESSEESESSSSESEESSERESEESSSERSRREESSSESESESEESSSESESSEEESEESSSESEEEESSESSEREEESSESEEEESSEERSSSEEEESSSEESSSSESESESSRSSEREEEESSSSSSSSSSSSSEESSSSSSRSEESSRRSSSESSEEESSESSEESSEESSEESSEEERSEESESSEESSSSESSESRSSESEEEESSESSEEESERSESESEEEEESSSSRESSSEESSSSESEEESSESESSSSEE
RSESE--SEESESSSSRSSESESRSSESSSSESESRSESSERSESESESSSESEREESEEEEEEESESSESSSSSEESESESEESSEESSSESSSEEEESESERSESEEEEESSREESRREEESRSSEEESSESSESEEEEESESSEEESSESESSESSSSESSSSSSESSESSESESSEESEESERSEESESEESSSSSESEESSESSSSSSESSEEESSERESERESESSSESESESSESESSRESSSREERRESEESSESEESSSESEEESEREEESESEESESEREEEEESSEESSESRSEEREESESEESESRSSRSEESSSSSESESSSSEESERESSSERSESEESSEEESESSEEESSSESSSSSERESSEESEEESSSESSSESESESSSE
SSSSSSSESSEEERRRSEEESESSSEESSESEEREESSSESEEESSSSEESEESSSSSRSESEESSSSEESSESSERSSESSSRSSESSEEEESSEESSSSSEEEESSSSSEEESESESEEESSERSSSSSSSSRESSSESSSSSSEESESSSESSSSESSSSSSSSSSSSESEEESEESSESSSSSESRESSEESRSSEESSEEESESSESESSSSSSESSSEESSEESSESEESSSSSSRSSSSSSSESSERSSESEESESSEERESESEESSERSRSSREESSSEEERSSEEEESSSSRSESESSESSSEEEESEESESESSSRSSEEEEESSSSEESEESSSEEESEESESSSSEEESSSESESSSEEEESSSSSSEESSSESSRESSEESSSSSS
EESSSSSSSSSSSSSESESSSSEESEEEESSSSSESSSSSSSSSESSEESSSSSSESERESEESSESEREESRSSEESESRESESSRSESSSESSEEERSRSSESRSESSSSSSSESSSESEESSESSSEESREESSSSSSSSREERRSSSESSESSESSSESSSEESRESEESSSEEESSERSEESSSSSSSSEEESSSREESEESSSSSERSSRESESESSSSSESSSESSEEESESESSSESESESEREESESSEERSESRRSESSSSSESSRSEESSSEESSSREESERSSSESSSRSSSEEEEEEERRSRSSSSESSSEEESSESESESRSEEEEEEEESESSSEEEEESESSSRSEESSSSSEESRSSERESEESSSSSSSSEESSSESSSESE
ESSSSESSESSESEEEERSSESSESERSSSEESSSEESSESSSSSSSESSRSSSESSEESSSSESSESSEESESRSSSSESEESERSESESSSESEEESSESESSESSSRSEESSRESEEESESRSSSSSESESSSRESSESEESSSRSRSRSEREEEEESEEEESSESRSEEEESSESEESSSESSSSSESSESESSEESSSSSESSSEESEESEESSESESSRESSSSERESSSSSSRSSRERRSSESSSSESEESSESSSSSSEESSERSSSSSSSSSERSSSSSSEERSSSSSEEERSSESSEESSSSSSESSESEESSEESSESSESSSEESESSESSRSSESSSESSEESESSSSSSESESEESESSEEEEEESSSSRSSESSSSSSRESSSRS
RSSSSEESESESSSSESSESSSESSRESSSSESSSSRESSREESESESSSESSESSSESSEESRESSEESSESSESSSEESSSSEESRSESSSSESSEESEESESSESRESEEERSESEEESERRRESSSESEEESESEEESESSSSSSERESSEREERESSSSREEEEEESEEESSSEEESERSSSSSSEEESSREESESSSSESSRRESESSSSSESRSRSSSEEESSSSSSSEEEERSSRESSSSSSEEESEESSSSEEERSSESESSSRESSSEEEEESESESSSSSEESEESEESRSESSSSESRSSEESSSESSEESSEERSESSSEESSESSSSSEREESSSSESEESSEESRSREESSSESESESEESESSSESESSSESEESEESEERRSS
ESSESSESSESSSSESSSSRSSSSSEEESSSEESESSSSSSEESSSSESESSSESSSSSSSESREEESERESSEEESSESESSESSESEESSEESSEESESESSRSESSSESSSSSESESSSSSESSSESSSESSSSESSRSSERESSSEESSSEESSESSESSSSEESSESERSSRRSSSSSESSSESSSSEREEEERSSSSSSRSSRSESSESSSESSSEESSSSSSSSESSSSSESSSSSRSESRSEEESERRESSSEEEESEESEEESSESERESSSSSESSSESSSSSRESSESSSSSSSESSSSSSEEESEEESESSSSSSEESSESESEEEEESSRSESSSSSSSRSRSSSSSSEESESSSSSRESSSSERSSSEEEEREERESSSESSEEER
ERSESEESESSESESSSSSREESSSSESSEESEEESESSESESREESESESEEEEESSESSEEEESESSSSRESSESSSSSEEEESSEERSEESEEESSSRSESEEEESSSSRREESEEESSSSSSEERSSSRSSEESSSEESSESSSSERSESRESSESSSESSSESSEESSESSSSSSESESSSSRSSESERESESSSSESESRESEESSSSEREEESSSSEESEEEESESEERSSSEESSSSEERSSSSSSRSSSSRSEESSSESSSESSEESESSERESEEEESSSSSRSSSSEERSSRSSEEESSSESESSEESSEEEEESSESSESRSRSERSRESESEESSSSESRESEESEESSSEEESSEESSRRSSSSESSSSSEESESERSRSERRESS
