                                                                                           ***    *|*                                                         ***     *|*                  *|*                                                                         *|*          *|*                       ***               *|*                      *|*                                    ***  *|*        
                                                                                           *|**** *|*                         ***                             *|*     *|*                  *|*                                                                         *|*          *|*                       *|*               *|*                      *|*                                    *|*  *|*        
                                                                                           *|**|* *|*                         *|*                             *|*    **|*                  *|*                                                                         *|*          *|*                       *|*               *|* ***      ***         *|*                                    *|*  *|*   ***  
                                                                                           *|**|* *|*                         *|*              ***            *|*    *||*                  *|*                                                                         *|*      *** *|*                       *|*               *|* *|*      *|*         *|*       ***                         **|*  *|*   *|*  
                                                                                           *|**|*  |                          *|*              *|*            *|*    *||                    |                                                                           |       *|*  |                        *|*                |  *|*      *|*          |        *|*                         *||    |    *|*  
                                                                                           *|* |   |                          *|*              *|*             |      ||                    |                                                                           |       *|*  |                         |                 |   |       *|*          |        *|*                         *||    |     |   
                                ***                                       --    -   --      |  |  --  -      -- -        ---   |--         -    |  -  -  -  ---|     -|-- -  -  -   --  -   ---      -  --    -        -    ---   --         - ---         -   -     -----       |-  - - -   -    - -        - |   -  -  --    - -   | -   -  |     -   ---   ---- -|  -     --  -           ---|-    -  - -|  -
                                *|*                                      -ES-- -E-- ES-- ---|-----EE -E--    EE S   -----SEE --|SS  -- ----S----|- E -E  S -SES---- -E-EE S--E -E- -SE -S---SEE---- -S -RE- --E ------ S----EEE - EE--- -  - R-SSE--- - ---E---E---- SSEES--- ---|E--S S-E  -S----S E-----  -S-- --E- S- SE-- -E-E-- --E-  E--| --- E---SER --ESSS E|--S-----ES--S-  ------- SES|E--- E- E-S- -S
                                *|*                                     -SEESE-EEEE-EEEE-SSE-ESEEESE-ESRS----RS-S---EESSSESE-ES-ER--EE-EESRESEEE-E-E-EE--E-SSEEESSE-EESSS-SRSE-ESE-EEE-ESEEESEEEESS-ES-ESRS-SSS-SESSSE-EERERSSE-E-ESESS-S--S-EESEEESS-S-EEESESSESEEE-ESSEEERS-EER-SEEE-SEE--EESEESE-EESSEE--RSSS-RESE-EE-SEEE-EESSSS-EEEE--SEE--SSE-SESSSER-EEEESS-E-EEESEEEESEESSR--ESSEESE-SSS-SESE-EE-SESE-SS
                                *|*                                    -SESSSSREESESEESESSERESEEEEESESEEESSESEEEESEEESESEEESSEEEESSSSEESESEEESSSEEESEESEEESSRERESRESSSESSSESESEESSEEEESESEESESESESEESSSSSESEEEESSSSEEREEEEESEEESSEEESESEEEEEESESEESEESEEEEEESSEERSSEEEEESESESEESESEEESSEEEEEERSEESEESEEEEEESESESSEEEEESEESSESSRESSESEEESESESREEESREEEEEEEEESESEEEEEESSEEEERESEEEEREERSERERSSESESSSSSSEESSRREESSE
                                *|*                                   -EEESSEREEEESEESEESEEESEESEERESSSEESEESEESSSSESESEEESEEEESEEESSESSESSESEESEREESREESSSSEEESSEEEESEEEEEESESEEEEEEEEEEESSESSEEEREEEESSESEESEEEEESESSEESSEEESSSSEEEEEEESESEESSSSEEESESRESSREEESESSEEESESEESEEESSSEESEESSRESESESEERRSSSESSEESSESEEEESEESESEESSSRSERSSESERSESEEEEEEEESEESEEEESEESEEEEESEESESESSSERESSEESSEEESSESSESEEEESEEESSSEE
                ***              |                                   -EEESSEREEEEEEEESESSREESSSSEEEESEESEEEEESEESESEERSSSSRSESEEEESSESSSERESREEESSSSEESESEERESESSEESEESSRRSEESESEREERESEEEEEEESEEEESSSSSEERSSRESEEESSEEESSESEESEESESSSSEEEESSESEESEESEEEEEEEESERSREESESSESEESEEEESRESEEESSSSSEEEESERSEESSESSESSERREESEEEEEESSEEEEEEEEEESESESEEEESEESEEESSEEESSEESEESSSESSESSERSEEESEESESESEREEEESEERSSSESESESEES
                *|*              |                           --     -SEREESRSSEESSESSSEEEEEESEEEEESSSERSERESEEEESSEERSSRSESEESEESEEEEESEREERESEEEESEESESSSSSRESEREREESSSSEEEEESEESEEEREESESSSEESSSEEESEEESSEESEESSEEEEESRSSEESSEEEEEERSSEEEEESEEEERSSESREESEEERRSESEEEESESRSSEESSEEEESESEEESESRSSESESESEESSSESEESSREEEESESESESEEEESEEEESSEEESEESEEEESESESSRSESSSEEEEEEEEESSESESEESSSSSESSESSSSEESSSEESESESESSERE
        ***     *|*           --------              - --  ---SS-----EREESEEEEESEEESEEEEESESESEEESESESEEEREESEESEESESEEEERESSEEESSSSESESESESESSESESESEEESESSSEEEEEESREEEESEESRSEREEEEEEEESSSSSEEEESSEEEESEEESEESEESEESEEEESEESEESSSSEREEESSSRERRESEESSSEESESSEEESSSESESSESEEESSEEESESSRSEEESESSEEESSERESEEEREESEEESSESESESESSEEEESSESESEEESRSSESSEESESERSESESSEEESEESSSESEEESSSSSESEESEESSERSEEEREESSEREESESSSEEE
        *|*     *|*          -ESESSEEE-    ---  - --E-EE--EESSSEESEESEEESEEEESSSSESSESEEESSSEESSSEESSESSERESSESESEEEEEEEESSESEEREEEESESSESSEEESEESEEESEESSSEEESESEEESEERRSESSSSSEERSSSSESESEESREESESEESEESEESSSESSESSSSEESSESERERSEEEESESSESSEESEEERESESSSEEESSEEEEERSSSESEESEEESSSEEEEESSESSEESEESSEEESEREEESESESSESSESSESSSSSESEEEEESESSSSEEESSREESESEESSEREESEESSSSSEEEESEESSSESESEEEEEREEEREESEEEESSEEESESES
        *|*      |      --  -SSERSEESES----SSE--E-ESSESEEEESEEESSSRESEEEEEEESSESESSSESESEEESESRSERREESSEEEEESSSEESEEESESSESSEESEEEEEESEEEEEERSEEESSSSSSSSESSESESSESSESESEESSSEEESRSSSESRSEESEEESSEEESEEESESREESEEEERESEESSESEEESRSESRSEESESSEESSSSEESEESEEESSSESSEEESEESSSSSESESSESSRSESSEESSSSEEEESSSESEEEEESESSSESSSSRSEESESSRSSEEEESSSESEEEEEEESEEEEEEEEEEEESRSEESSERESESSSESEESSEESEEESEEERSEEEEESSRESESSEEE
         |       |--- --SE--SSERRSSEESSRSEESSEESESSESERSESEESEESESESSEERSEEEESSEEESSESSESESSEERESSEESERSEERSESSSESEREEESESEESSEESEESSSESESSSSEESESSSSRSSSESEESEEEEEEEEEESSSSESSSEESEERSSSESESESSESSSESEESSERSEESRSESESEESEESEESSEEESEESESEESSESESEESSEEEESSESSSSSEEESSESSEEEEEESSSSESSEESSEESEESEESESSSSESESSSESEESSREESRERSEESEESEEEESSEEESEESSERSESSEEESEESEERRSESREEESSESEESESESSEEESESSESEEESSSEEESESSSESSEE
         |      --SES-EESEEEESSSESSESSSESSESSSSEEESSSSSEESEREESSSRREEESEESSESESESEESSSSSSSESSESRSEESSESEESESSEESESESESEESSSERSEEEESSSSESEEEESEESEEEESEESESESSEEEEESSEEEEEEEESEEESEEEEEESESESSESSSEESEEESESSESESSSSERSSSSSSSERSESSSSEEESEESERESEREEEERESESEEEEEESSSSEEESSESSEREEESSESESEEEEEERSSESEEEEESEESESEESEEREEERSEESEEEEEEEESESESRSESSEEEESESSSSSSESEESEREEEEESESSEESESERSEEEEESSSSSREESEEESSEEEEESESESRSS
         --   --SSESSSERESSEESSSEEEEESEESESREERSESERSSESEEEEEEEEEESEESESSSEESEESESEESEEEEERSSEESSESESEEESSSSEESRRESESESRSSESSESSEEEESEEESERERESEESESESEESESESESSESEREEESEEEEEEEEESSESSSSSSEEEESEESREEEEESSESSERSEESSSEESESESSSSEESREESEEERSEERESEEEEESRSESSESESSEEREEESSESEREEEESSESESSSSSEEEESSSEESSSERRSSESEESESESEEEEEEEEEESSESEEESSESEEERESSSRESEESEEESSEEESEEEEESESSSSESESEEEEESEREESSEREEESESESSEEESESESES
      ---ES---SESSSEEEEESEREEEEEESSSESESSSESSESESEESEEEERRESEESSRSEESERESESSREEESSEEEEEESSESRESESEEEESRESSEESSRESSSSESESESSSSSSERSSEEESSESESSEEESEEESEEEEESESESERSSEESSSSESEEEESSEEEESEEEESSSSESSEERESESSSEEESSSEEEERESEESESEESSESESESSEESESSSEESEEEEESREEESSEESSSEEEEEESEESESEEESSSSESEREESEEEESSESESESSESESESESSSEEESSSEESSEEESSESSSRESEREERESSESSRSESSEESEEESERSSEEEEEEEEEEEEESESEESEESSSESEESEEEESSSSSSSERSE
 -- --ESERESEEESRESSSESESSSSREESSESSESEEESESSEEESESEEEEEESSEESRESSEREESESRSEESEERERSEERESSEEESEEESSSEESSRSEEEESSSSRSEERESSSEEESREEESEEERESSSRSSEEESEEESSSSESSEESSEEEEEEESEESEEESSERRSSSRSESEEEREEEEREEEEESEESSESEEESEERESSRESSSRSSESRSEEEEEEEESSESSEEEEERSEESSEEEEEEESESEEESESESESSESEESSSEESSSEESSSEEEERSSEESEESEREEESSEESSSESESEEERESSESEESREEESSERESEREERERSRREREESSESSSERESESSEEESSSEEEERSEEEESESSEESEESEEER
-SS-SEEEESEEEEERRSESSEEEEERSESSEESSESESRESSEESEESSERSSRSSSESSSSESSSESEESESESEESERESEEEEESEREESEESSSSEESRESSSEESEEESSSSSSESSRSESESEESSEERSEESEESEESESEESSEEEESSESSEEEESSSESSSSEESESSSSEESSSEEESSESSSEESEESEEEEEEESSSESSSSEESSSSSESEEEREEEEEESSSSEEESREESESESEEESRESSERSESSSSSESEESSSSRESESEEEESSESRSSSESEESEERSSSSEESESEESESEEESSSSEEESEESESESESSEREEEEESSSESESEEEEEEESESSESSREEEESEEESEESSSESSSESSEEEESSESSSSEEE
EEESEESESSSSEESESSSSEEEESEEEEESEEESEEESEESSSESEESESESSEEEEEEEERSSESRSERESSSEESESSESSEESSEEEEEESSRESSSESESREEESEESEESESEESSSEEEESESSEESSSEEEESSSEESRSESSSSEEEEESEESEEERSEEEEREESEESSESSEESEESEEEEEESESSSSESSSESESEESSSEESREESESSERSESSSSERESEESESSSSESESESSEESRSESSESEEESSSREREEEEESSSSESSSESERESEESEESSESSRSSEEEEREEEESSEEEERERESESEEESEEEREESEEESERSEEEESSREEEEEERSSESSSSRSEESSEEEEESSESESESSREEERSEEEEEEESSEEE
EEEESSESSEEEESEESESSESSRESSSSSSEEERSSSEREEESEESEEESEESEESESEEESSSSSRESESSESSEEEREEESSEEESEEEEESSSSEEESESSSSSSSSRSEEEESSSSESSSEEESRSEESERSSEESSSESSESEEEEEEEEEEESESESSEEEEEEEEEESESRESRSSEEREEESSSESEESESSSESESSESESSEESSESEEEEEESSEEEREEEEEEESRSSEEERSEEEEESSSSSESSSEESSEEERSSEEEEEEREESEEESEESESEEEESESSSSERSEESESSSSEESEEESEESSESSSSEESSEEEESESSRRSEESSEESESSSRSESSSEESESESSEESSESESSEESSRSSSSSSRREEEESESEESSE
ESEEESESSEEESSSESEERESRERSSESESESESSESESREEEEEESESSSSSESEESESSEEESESSEESEESEESEESSSSEEESEERSSRRESSESESSESSSEESRSEREEEEEEESEESSEESSESSRSSESSESSESEESEESEEEREESESREEEESSEESESSEESSESESRREEESSESESSEEESREEEESREEEEEESESSSESSEREREESEESSSSEEESEREESSSEREEEESSSEESESSEEEESEEESSSSERSESSSSESEERSESEESESRSESEEESEEEESSSRESEEESSSSSEESEEESESEESSSSSSESSSSSEESEEEERSEEEEEEEESEEESSEESESESRRSESSSSEEEEESESSSEESESSSSSSEEEE
ESESEERRESSESSESSSSEESSSSESEEEESERESESSEESERERRSESSSESESESEESEEEEEESSEEEEEERERSSSSSESEEEEESESSEESEEEEESESSEEESSSSESESESSSSESSREEESESESEEESESSESRSESERESESEEESEESEEEEEEESESSEERSESSEEESSESRSESESSEESEESSESSSESEREERESRSESSSSRESEEEESSESESRSESESSESESESEEEESSSSSSSRESESSERSSEESESSEEEERSESSSRESSSSSSEERSEESEESSSRSSESSESESSSSSSSESSSESESESESERSRESESEESSESSSSSEESSSSESSSSESESSSSESSSEEESESESERESREESSSESSEEERSSSSE
SSSEEESESRSSESSEESSERSRESESEEESSSEESSEEEESSSSREESSRSESSEESSSSESSSSEEEEESSEESSSSESSERESSESSESSSSSSSSESEESSESSESSSEEESESESESESSEESESEREESSESEESESESEEESRRSSSEESSESSSESERESESSESSESEEERSERESSESEESEREESSESRSSSEESSSSEEREEEEEEEEREEEEESSSEERRSEEESRSESESREESESSRSEEEESESESESEESEESSSEEESESSEEEEEESSSSSSERSESSRSESSRSESSEEESEESESEEERSSSREERSESSEEESEESSSSSSEESSSESESERSSSREESSERSEERESERSEEERESSSSSEERSRSESERSSSESES
EEEEESEESSESSSSSESSSSEESEERESSESSSESEEEEEERSSSSESSRESEEESSEESEESSSSSEEEEESSESESEEESESSSESESSSSSSSSSSESEESSSESSESSSERESESEEESRSSESSEEEEEEEEEERSRSRESESESSRSESESSESEERSSERESESEEEEEESSEERSEESSSSEEEEESSRSRRSSEEERERSSSSSSSEERSSSEEESSESESESSSSSEESSEESSRESSESSSESREEESESSEEEESSSEESEERSSEESSSSESESEEEEESRSSEESSERSSSSEESESSESRSSESEESEESEEEEESESSSESEESSEESEESESEEESSRSSRSSEESEESSSEESSESESSSSEEEEEESESEESSEEESSSE
SESESSSERSSEESEEERSSSSSSSSSERSESEESESSSRESSESEERESSSSEEESSSSRSSSSSEESEEESSSEESSEEESREEESERESESRSSSSEEESEEESREESSSSSESEEESSSESESEEESEESSSEEEREEESSSSSEESEESSESSEEESSSEEESSESSESESEESSESSEESERSESSSESSSESEEESSESSSSEESREEESEEEEESESSSESSESREESSSSEEESESSSSSESEEESESESSESESSSESSESRRESEESSSSESSSESESEEERSESESERESSESESESEESEESEEEEREEESSESESEESSSSSSSSEERSSRSEERESESSEESSESESESESEESEERSSSSESEREEEESESEEERSSESESESE
EEEESRSREESSESSESEEESEEESEESRERSESREEESEEEESEREESSSESEESESESREEESSESESSSSESSSRESREESSESSSSEEESSSSSEESEERSSSSESSSRRESESSSSSSSESSSRSESRSSSRESEESSERSSEESSESERSEERSESSEEESEEESSSESSSEEEESEESESSSSESEESESESESESESESSESEESEEEESEESSESEESERSESSEESSSSSRSESESEESESEESSEEEEEESEESSSSSSESSSESEESEESSSEESSESSRSSSSSESSSSSEESEESESSSSESESSRSESEEESSRSEESERERSESEESEEEERSSEESEEESESESSEEESSSEEEEESERSSSEEESESSSRSESSSSSERESE
ESSSSSESEREREEEEEESESESESSEESEESSSESSSREESSSSSESEESSESREEEESSSEEEESSEESESRESSSERESEESEESESESSSSSEESESESSSSEEESSSSSESSSESEREESSSESRSRERESEEESEEEESSESESEEEESSESEESSRSESEESSSSESSSESSESSEEEEESESEESESESSSSSSSSREESSESSESESRSESSEESSSSESEESSSESRSSSEESSREERSEESESEEESSESSEESESSSSESSEEEEREEEEEESESESSEESSSREESSESRSESESSESSESEREESSSSSESSSSSEESSESEESSESESEESSESEESESRSSESSSESSSEESRSSERSSSESESSEEEESSSEEEEESESSESE
ESSEESESSSSRSEEERSSSSSSSEEESEESSEESEESEESSSEESESSEEEEESSEERSESEEERSSESEESSSESRSSEESSSREESESESEESSSERSEESSSSSSSSESESSEESSSSESSSSESESERRESEERSRESEEESESSESSSSSSEEEESEESESESESSEESESSESESESSSEESEEESESREEESESSEESSSSESSSSSESSSESESSEEEESEREESSRESSSESEERSESSESSSSEEESRSEESSSESSESEEESESREREESSSSEESESSESRRSSESSSESSSSSEEESERREERSEEERRESESESESSEESSSESSEESSESSEESESEEEEESSEESEERSESESESSESESEEEESSSSESESSSRESSESSSR
ESESSSESSSERSSSESEEESSEERSSEREREEEESEESSEESEESSRSSESSRSEESSRESESSSESEEEEEESEEESEESSEEESEEESEESESSSESESSRSSESSSEEREESESSSSESESRSERESSEEESEEESEESESEESSSESSESESESRSRESSSSSSEEESEESSESRESSSEESSSSSESEESSREEESEEESSSEEEESESEESSSEESERSEEEEEEESREESESSESEESEESESSREESEESSSSEEEESESSESSSSEEESESSRSESESESSESSSSEESEEESSERERSRSREESEESSESESESESESSERSEESRSSSESEESESRESSSESSSSRESSEEESSESSSSESSSERSEEEESSESESSRESSRSSERES
RSESESRERSEEEEEEESERSESSSSSSEREEERSSESSSSSSEEESEEESEEESEEEERSESSESESRSEERSSESSSEEREESESRSEESESSESSSESESSSSSRESEEESESSESSSSESEEESSSEERSSSESSEEEESSESSESSSESESSSESESEESSEESEESEREREEERSSEERESSESSESRSSEEEERSSSSESEESSEEEEESSERERRSSRESSESSSSERESREESSESESEEEEESSSSSSESESERSESEESESEEESESESSESSESSSSSRSESSESSSSSESSSESERSESESSSESEEEESSSSEESSESEESESSSESSESSESEESSSERSSESEESSEESEREESESSSRSREESEESSSSSSSESSESSESSEE
SSERSSESSESESESSSEEEESSRSESSSEEEESESSERSESSSSSRSSESSSSESSSSSSSSERESSEESEESSSSEEESSSESEESEESESSSSSSSEESSSSSEEEEESSREEESSESSSEREESESRSESSESESSSSERESESRSSREEESSEESESEESSRESSEEEREEEEEEESSESSESESESESSSSSEESEESEESSSESSESEEEEESSSSSSEEEEESSESSSSSSSEESRESESESSSSSSSERSRERSSRESESSSESERESSSSRESESSSSSSESSEESEESSSSSSSEEESSSSSEREEEEEESSEESEEESEESSSSSERESSSESESEESERRSEEESEEESERSSSSSEESRESEEESSSSEESESSEESSESESEESS
ESESSEEESESESEREESRERSEEEEESESSEESEESESSSSSSESSSEEEEEEERSSESRSSEESESESSSSRRSEERSEERSSEESSSSEESSSESSESSSSESSSESEEESEESSEEEESEESRSSSESSESSEESESEESSESRSSESEEESSREESEESERSEESESEEESSSRESESESRERSEEEESERESESSSSSEEEESSSSESSRESSESEEREESSESRRSEESSSSESSESSEEEESSRSESESSREESEEEEESRSSSSSESSSSSESSEESSSSSESSSESEESEESSESSEEESSESSSSSESSSEESESSESERSESRESSSSSEESSEESSEESESSEESESSSSESSSSEESSRSEEESSSEEEESEEESESESSESESSR
SEESSSESSSRRRSSESSSEESSSEESSSSSESEESESRSSSSSSSSSSESSESSSSRSESEESSESSEEESSESSSSSSSESESSSEEEERSSSSSEESESSSEESSSEESSSESESSERESSSEESSRESSSESSERSESSSEESEEESSSSSEESSEEESSEEESSESESRSEESSSSESSSESSSSEESESEEESSEEEERSEESESSSESSSSSSSSESESSERRSESESESSESSEEEESSEESSESSSSESRSREESSRSRSSSEESESSEEEESSEERREESSEESSSSSSSRSSESSESSSSESESSSEEESSSSESEESEEESESSEEESEESESSSSESRSSSSSESSEESSSESSESEEEREESSEESSSREESESSSSEEESESSES
SSERESSEEEESSSESESEERSESSSESSERSSEESSEEESESEESSSSESSESESSESRSESERSSESESERESRESRSSESESEESSSRSEESEESRSSEESSREESSEERRSEEEESSRSESSEEERSSESSSSSEESSSSEEESSSERSEEERESEEESSEEESSSREESRSESESRSESSSESEESSSSSRSEESSSRSSEESSSSESSSSSSRSSSSESRSEESSSSSSSSSESSESSSSSSSSSSERSSSSEESRSESREESSSREEEESESESESESEEESSSSSRSRSSSSERSESESSSEEESSSSESESRSSEEEEESESSESERSSSESSSEESEESESESSRRSSSSSESEESRESESESESESEEEESERSRSERSSSSSEESSSE
ESEEESEESEESSESREESSEESEESESESSESSESERSSSRSSSSSSEESESESESSSESESESESEESEESSSSSSSSERSEESERSSSSEEESSSSSSSSESRSEEESEEESEEEESSSESESREEESSSSSSSSSSSSSSSSSEEESESRSESSEESESSSSSESSERESSEEESSESESSSSEEEESSSESESEEESSSSESESSSSSEESSSSSSSSSRSRESSEESESSESSESEESSSRSSESSSESESESESSSESSEESESEESEESSSESEESEESSSSSSESREEEESSESEERRSESEEEERSRSEEEESRSSEEREEESSSSSESSESSESSSEESSSSESSSSESSRRSEESESRESSSSSSSSESSSSSSSEEESSESERESRE
SSESERSSRSSEEESSSSSSSESSSSESSSSERSSSRSEERSRSSSSERSSESEERRSSSEESSRSEEEESESSSESESESSSESEESSEESSSSESREESSEESESSRSSSRRESRSSSSRERSESSSSESESSESERESSRSESESSREEESSSERSSEEEESSESSSSSSRESSEEEESSSSESESESESEESSSRSSSESSSRERSSSESSSSSSREESSSSESESEREEESSESSEESESSSSRESESSSRRESSSEESESSSESSSSSSSESSSRSEESSESRSESESSEESSSESERESEEEESSREESSSESSESEEEESEESSSSEEEESSRSEESSSSRSESSEESSSESEEEESESESSSESSESSSSESERSRESSESESESSSSESS
RRSEESSSSSSSSEESESSSESSSSEESSRSSRSSSRSSEESERSESSSSEESSSEEESSSSREESSESSSSSESSESSSESSREEEEESSSSEESEESESESSSSSSSSESEEEEEESSESEESSRSSRERSSSESSSESSEEEERSSEEESSSSRERSERSEESSESSERSSSSRSESSESEEERSERSSESESSSESRSEESSSSESSEESEEESESSESEESESSSESESSRSESRSESSESSESSESEESSSSSSESEESESSSSSSSSESSSEEESSSESSESEESESESEESSSRESESSSESSESSSEEEEESSSESEESREEEESSESSSESESRSSRSSEESSESSEEESSESESSSESRSSSSSREESSSSSESESSSSESSSSERESS
