                                                                                                                                 *|*                                                *|*  ***                        ***             *|*                                                                   ******          *|*                  *|*    *|*                    *|*                  ***           
                                                                                                    ***                          *|*                   ***     ***        ***       *|*  *|*   ***                  *|*             *|*              ***                                    ****          *|**|*          *|*      ****        *|*    *|****                 *|*                  *|*           
                                                                                                    *|*                  ***     *|*                   *|*     *|*        *|*       *|*  *|*   *|*                  *|*             *|*              *|*                                  ***||*          *|**|*          *|*     **||*        *|*    *|**|*                 *|*      ****        *|*           
                                                                                                    *|*      ***         *|*    **|*                   *|*     *|*        *|*       *|*  *|*   *|*                  *|*             *|*              *|*                                  *|*||*          *|**|*          *|*     *|||*        *|*    *|*||*                 *|*      *||*        *|*    ***    
                                                                                                     |       *|*         *|*    *||                    *|*     *|*        *|*       *|*  *|*   *|*                  *|*             *|*              *|*                                  *|*||*          *|**|*           |      *|||*         |     *|*||                   |       *||*        *|*    *|*    
                                                                                                     |       *|*         *|*    *||                     |       |          |         |    |     |                    |               |                |                                   *|*||*          *|**|*           |       |||          |      | ||                   |       *||*        *|*    *|*    
                                                                                                  - ---       |    --     |      |---    - -    -   -  -|-  ----|  - --  - |- -   - -|  - |     |-    --- -- -  -    |    - ---  - --|-  -- - -       |-- -     --   --     -       -    - | ||     -      |- |    -      ---- - - ||| -   -    - ---- | |--  --- -  -      - - -- -- -|| ---   -  |    - |---- 
                                                                                                - S-ESE-- --  |-- -EE---- |----  |SSE- - E S ---S-  E--S-S  EEEE- -E ER -E--E-E---E-S---E -- ----E ---EEE-ES-E--E  - - - -S-SRS- S-EE-E -EE-S-S-----  -SS-E-----EE---EE- -- E -  -- E--- E-|--|  -  S -----|S-|----R-- - -ESEE S-S--|- E --E----E SSEE----RS--SSS-E--E----- S-S-ES SE-R|| EEE --S -| - -E-|SSEE 
                     ***   ***    ***                                                           E-SEESESS-SE---EE-REEEEEE--EESE---SSSE-E-S-E-ESSEE--ESESEE--SEESS-ES-ES-SSSESEEESSESEREEE-SE-EEESS-SESSSSESEEEEES--E-E-E-RSSEEES-EEEESS-EEEEREEESESE--EESSEESSEEESSRSESE-ES-E-E--SE-ESES-EE-SE---E--E-EEEEE-SR-SSESEEE-S-ESEES-EESSE-E-E-SSSEEESS-ESESSESSSSESSESEEEEEESEEE-REEEEE-EEES---EEE-SES-S--E-SSE-EEEE-
                     *|*   *|*   **|*                                                          -EESEEESEESSSEEESEEEEESERESESESSEESEEESSESSEESEESEEEEEESSSSSSEESSRSSESEESSSEEESSSSSEEEEEESEEEEESESSSEEEESESSSSSSESESSERSSSESSEESEEEEEEESSSEERERESEESSSERSSEEESESSSSSSSSREESESSSESSEESEESEESSEESSESEEEESSEEREEESESEEEEESSSSEESSEEEEEEESSSSERSSEESSEESEEEESEEESREEEERSSEEEEEEESESESEESESREEEESEEESESESSEEESEEESEESE
                     *|*   *|*   *||*        ***                                              -SSSRESESSRESEEEEEEESESESESSEREEEESESSSEEEEESEESSREEESSEESEEEESSSEEEESESEEEESSSSSESSSEEESSSSSESSSSEEEESEESSSESESESEESSEEEESRRSEEESSSESEEEESESSSEEESESSREESEESEEESESSSESSESESESEEEESESESSSSEEEESSSSSSSEEEEESEESEESSSESEESSSESSERERSEESEEESEESSESSEEEEEEESSESSEESSSESSSSSSESSSSRSEEESSEEEEEEEEEEEEEEESEESSESSSESEEES
                     *|*    |    *||*        *|*                                       ----  -ESSESEESRESSEEERREEEESSSSSEEESEEESESEESEEEEESSSESEEEERSEEESSESEEESEEEEEESEEESSEEESSSEESSSRSEEERESEEESESESSERSSESSSSSESSEEESEEESSSEEESEEEEEEEEERSSESSSSEEEEEEESEESSEEEEEEESESESESREEEEEEESESSEESESEEEEEESESEESSSEESEEEESESEEEESEEESERSEEEESSSEEESEEEESERSSESEEEESESEEEESSSSEEEEREESEEEEESEEESREEESRESSEEESSESSSEEEE
                     *|*    |-   *||*        *|*    - --                              -ESEE--SEESSESESSSEESEEEEESSESSESSSREESESSSESEEESEEESSSESESEEESSESEEESESERSEREESESSREEEESESSESSEEESEEEERESSEEEEESSEEESEEEESEEEESSEESSEEEEEESEESSSSSSEREEEESRSESEERSESREESEEESSSEEEESEEEEEESEEEEESSESESRSESSSSSEESESSESEESEEEEERSEESSSSSEEEESSSSESEESESSEEEEEESEESEESEEEESSESESSSESRESEESEEEEEESEEEEEREESSSSSSESESSSEEEEESS
           -    ---- *|*    -E-   ||         *|*   -S-ES-      -- ---            -----ESEEREEESEEEESSSSSSSSESRRESSSEEEEESSEEEESESESEESSSEEEESEERSESEREEEESSSSSESESEESEESEEESESEEEESSEEESSSESSSSEEESEEESSEEEEEEESESSEEEESESESESESESEEEESERESSSSSSRSEEESSSSEESSSEESSSREEESSEEESSEESESSSESEESEESSSEEEESEESSERSSSSEEESSEEEEEREEESREEESSSEESSSESSESSEEESEESEEESEESEESEEEESSESRERESSSESESRESEERESSEESSESSEESESESSESESE
          -S----EEEE- |    -SSE-  ||          |  --SSESSE------EE-ESS----     ---ESEESESEEERSESEEESESEESSEREEESEESSRESSSSSERESESEREESEEEEEEESSSSSEEEEESSESSESESREESEEEEEEEEEEEEEERESSESEESRSSSSEESREEESEEESSSESEEESESEESESSESSSSREEEESEEESSESSSESSERSRESSSEEEESEESSSEESSSSSEEEESEEESSEESSEEESSSEESESEEESEEEEESESEEESESESEEESEEEEEREEERSSESSSESRSSSSSSSESEEESEEEESSSEEESESESESRESSSSSSESSESSSEESSSEEEESEEERSSSEEE
        --EEEERRESSRS-|   -ESSRS- --  - ------|--EERSSEEEEESREEERSSSSEERR-----EESSEEREESEESEEEESSSSEESSEEESESESRSRSSEEESSRESESEESSSEEEESSSEESSESESSSSREESSSSEESEEESEEEEEEESEEESESEESERSEEESSSEEEEERSEEESESSEESEESEEEEEEEESESEESEESESESEEESSEEEEEEEEESSREEEESEESEESESESRSSERSSESSEESEEEEREEREESEESSEEESEEEEESEESEESSEESRSESESESEESSESEESESESESESESEEREESSESSEERSSEESRSSRSSEESESSSESSEEESSEESEESSSSEEEEEEEEESESESE
     ---ERSESSEESSSSEE----ESEEESS-SS--E-SESSRE-SSEESESSRSSSEEEEEESSEEESEEEESEEEESESESSEESESEEESSEESESSSEESSESREEEEREESEEESEEESEESERSSSSESSSEEESESEEEEEESESSSSEEESSESSSSEEESESEESEEERSSSREEESESEEESSSESEESEEESERESEEEESSEEEERESERESSEESSSESEEEESEEESREEESEESEESRESEEERSEESEEESESSSSERRESEESSSEEESESEESERSERESSRSSSESEESEEEESEEEESSESSSEESSSSSESSSSEERESSESESSEESSSEREEEESEESESEEEESESERESESSEREEESSSESSRESRRSSRRS
    -EEEESSSEESEEEEEESESSSSSESESSESEEEESSSSEEEESSESSEESREEEEEEEESEREEEEEESESESESSEEESESEESSSSEESSESREEESESSSSEESSESSSSEEESSSERSEESEEEEEESSESEESSSESEESSEEEEESSEESSESEEEREEESEESSSSSSESSEEEESREEEESESSESRSESSSESESSEEESREESEESEESESSESSRERSSESSEEESSEEESSESSRSSSEEESSSEESESEEERRESSRSESESESESSESREESSSSSSEESEESEESSSSESEESRSSEESEESSERSESSSSSSSSEESSSEESSSSSSESERESSSRRRESEEEEESSRSSSESEESEESESESSEESESSSRESESESE
   -SEESERSESESEESESESESSREEEEEEEESEESESSESEEEESSSEEESSSSEEEEREESREEESESEEESEESESERESEEEESSSSSSESESSSESEEEESSSESESERSEEESEESRESEEEESSESSSSSESESSSEEEEESREESSEEREERREEEREESSESEESSSESEERESSESSEESSSSEESSSESSESESESSSEESSSEEESEESEESEREEESEEESSSREEESSSESEESEEEEEESESSEREESEESERSSSEEESESEEESSEESSSEESESEESSEEEEEESSESSESSEESSEEESSSESERSEESEEEESSEESSEESSSSESESESRESREEEESSSSEEREESSEREREESERSSEEESEESEEEEESSEEES
 --ESSSESEESESSEESSSREEESSSESESEEEEESREEESEESSEEESEESSSEEESESESESREEERESESRESSEEEEEESESSESEEESSESSESESSESSSSSEEESESEEESEESEESSEEESSSREEESSEEESSESSSSEESRSESSESESSSESESSSEEESSSSSSESERESEEESSEEESSSSSSESESSEEEEEESEREESESSSREEEEEESSSEEEEEESESEEEEEEEEESESSESEESSEESSESSEESSSEEREEEESEERSERREEERSSSEEEEEESSESEESSESESSSSEEESSSSSEESEEESESSESESSESEESSESSEERSSSSESRESESSSEEESEEEEEESSSEEESSRSSEESEEESSSEEEESSRESEE
-ESEESSSSEESEREESESSEESESSESEEEESEEEERSSSRESRESSEEESESSESEREERSEESREEESESESSESRESEESSRESEESSSSEEESSESESSEEESSESRSSESSEESEEESEESSEESRSSSSESSSSESSERSRSEEESRSESSSSESSSSSEESESSEESSSESEESSEEEEEESEEEESEEESSESESSSEESSESESSSEESEEEESEESSEEEESSSSSRSSSESESESEEESSSESEESESESEEEESSSESSEEESREEEESSSSESSESSSSEEESESSSSSSEEEESEEEREESESSSEESSESSESEEESESEEESSESESSSEERESESESSEEESSSEEESESESSEEESESEESEEESEEESSSESRESREEER
SESEEEEESEEEESEEESSEESSSSSSEEEEEERSSSESSEEEEESRRSSEESESESEEEEEERESESSEEREESSERSRSESEEEESESSSREERESSESSESSESSSRSESSSSREEESEEEESSSEESESEEESRSESESEEEEEEEEERSSSESESREEEESERESESEEEEEESSRSREESSERESRSEESSESRSEEESEEEEESSESSESSEESEEESEEREEESEEEESSERESESESESEESESEEEEESSEEESSEESSSEEEESSESESEESESEESEESESSSEESESEEESESSSESESESEEEEEEESRESSESESERSSRSEESSSERSSEESESSESEESSSESRESEEEESSSESESSESEEESSSEESEEEERESESSSESS
SSSSSESESRSSSESSREESEESSESEESSEEESSEESESESSSESSEESSEEESEEEEESEEESESEEESREEESESEEEERESEESREESESSSESSREERSEESESESSESSSESSESESSEESSEESEEEESEEEESESEESSEESSSSEEESESSEESSESREESSEESESSEEERESSESEERSSSESESSEERRSEEEESERSEEESSSSEESEEESRSSSEESSESSSSSEEEEEEESEESESSESEESESESSSESSSSSSRERSSEEEESESESEEEREESEESSEESESSSEEESEESSESRSESSSSEERESSSEESSESESSSSSEERSESSEEREEEESSESESEREESSSEEESREESSESESESSREEEESESSSSEESSEESE
ESERSSESEEEEEEEEESSSRRESEERESESSSSESRESSESEEESSSEEERSEEESRRSEESSESEEEESEESRESESREESRSSEESSESSESSREEESEESSSSEESEESESESSESEEESSSSSEEESSSESEEEEEESSRESESSESEEREEESSEEESEEESESESRESESEEEEESEEEEESEEERSEEERSEESESSSESRSESSESEEEEEEEESESESEEEESEESSEEEEEESSSSSESESERESSSESEESSEEESRSSSEEEERESSSESSSSSRSERSSSRERSEEEEEEEESSSSEEESSSESEEEREESEEEEESSEEEESESEEESEESRSEEEEESSEESESSEESSSSEESEESSSEESEESEESRREEESESESESEESE
SESESSSESEESSSEERESRESRSEEESSSEESSEEEESESRSSSSESSEEERSESEESSEESSEEESSEESRESSREESSEESEESSREESESSEESEERSSEESSESEESERESSSSRESSRSSSSRSEESESSEESEEEREEEESEEESESSSSESEESEEEEESEESSSEEESSSEESESEESEEEERSEEEEESSRRSSEERESRRSERESSRESSSRSSESESEESSESEEEEEESSSSSESRESSEEESRSSEESSERSEEERSEESSSESERESESEESSSEEESSESEEESESSSEESRSEESSEESSESSESSSSESESEESESEEESSSSSSEEESSSSSESSESSEESSEEEEESRESSSESEESSSSESESEESESREESRSRSESS
ESSEEESESERSEEESSEESSSERSSERESSREESESEEESERESSSEESEEESSEEERESEESSEEESSSESSESSSESSESEEESEESESSREEESESSSEEEESEESESEESESEESEEEESSEESEESSEESSSSEESRESEESEESSESSSSSESEEEREESEEESSSESERESEEESSESSSEESRSSSSSSSESSRESSESSSESEEEEESERESSSESEEERESSEESSSSSSEESREESEESSSRSESSSESRESRSEEEEESSSEEESSSESEESSSSSEESEERRESEEEEEEESSSEEESSSEESEEEESESSESSSSSSESEEESREESEESSESSERSESESESSESEEEEEEEERSEEESSSESSEEEESSSSESESESRESEEE
SESRSESEEEEESSESSEESSSESSSSSEEESESESSEESSREESEEEEEEESEESSESSESSRSEESSSEESESSESEEEEESESSEESEEREESESESREEESESSERSESSSSSSSESEEESSESSERSEESESSSESEEEEESRSEEEESSSEESSEEEESEEESESSSSSSRSSSEEREESESSEESRESEESSSEESSERSEESESSSESSSESERSSEESSEESEEESESEESSESESESEEESSSSESSSSSSEESRSEESSEEEEESSSRESSRSEESEREESSSEESSSEREESESSSEESSSEEESERSRSEERSEESESESEESESESEESSSESSSEEESSEEESREESSSSESEEESSSSSESSESSSSSSEESESSSSSSEEESE
SEESSESRESSSSEESERSSEEEEESSSEESEREREESEERESEEESESEEEEESSSERESSESEESEESESESEEEEESSSSEESESSSEEESSESSRESEEEERESSSSESSESSSESSSRESSEESSSSESESESEEEEEEESREESESEESEEEESSEESRSSEESSESEESSESEEESSSSSSESEEESEEESEEESSSESSSEESSESESEEESEEEEEREEESEESRESESEESEEEESRSSERESESEEEEEEESSESSSSSSSRREEEESEEESERSSREEESSERSESESESESSSESSSEESSSEESESESRESEEESEERSSRSSEEESSREREEEESSESSESEESSRESSSESSEERESESEESSSSESSRESESSSSEESSESES
RSSEEEREESSEESEEESESEESSSSEEESSSESSSSESRRSESEESSESESSESEEESSSESSERESRSSSESSSEEEEESSSSESEESESSRSSSESSSSEEEEEESSSESESESSESSEESEEEEEEESSRERESERSEESEEEESSSEEESSSREESEESSEEEEESSSSEESEEESEEEEEESEESSSEESSEEESESEEESSESEESRREESESSSEERESSEEESSSSEESSSESSSSSESESEEEESEESEEESESREESSSEESESSESEEEEEEEEEESSSESEEREESEEESRSESSEEEESSESSESESSEESSSSSSESESEEESSEEESEERSESESSEESRSSEEESEEEESEESSSEESRSSSESEERRSSERSSSESSEERSE
SESSSESSSSRSESEESERESSESESESSESEESESSEESSSRSEESEESSSSESSESSEEESESESESEEERSSSESESESSESSEESEESEEEESESESRSEERESEEESSESSSESSSRSSSESEEESSSEEESSESSRSSSSEEEEREEEESESSSRSESSESEESESEEERESESEEEESSSESESEESEESEESREEERESESSESESEERSEESESSESSESEESESSSESEEESSESSSEESSEERESESSSSEEEEEESSESSSRESRRESSSEEEESSESREEESSSSEESESSSSESEESESESSSESEERSSEEESSEERSEESEESRSEEEEESSESESSSSEESEESEESSESSSERSSEEESEEESSEESSRSSESESRSESESS
SESESSEESESEEESESSSEEEEESSEEERSEESESEESRSSSSESESERREESEEEESESESRSSESSSRSSESSEESSSEEEESSESEESEESSSRSESSSSEEEEESSESEESSSEESESESEESESSEEESESSSSSERSEESSESEERESSEESESSSERREESSSEESSSESEEEESRRSESEEEEESSSSSEESSSESSEESSEESSEESSRSEEESSSRESSEEEESEESRSSSSSESESEEESEESSSSEEERSRESSSSESRRESSESESSSESSEEEERESSSSSSSSSESEESSSSSEESSEEESSEEESESRREESSSREESESSSSSSSSEEESSRSESSSERESESSSSEERSEEESESEERSSSSEESESEEEESSSRSSEEEE
SESSSEEREESESRSSEESSSSESSSEESSSSSESEEESSRSEESESSSESSESESSSSESEESESEESESEEEESSSESSESESESSESESSSEERSEESSEEEESESSESSSESSRSSSSESEESSESESRSESSESSSSSSEEESEEEESEESESSESSSSESSSEEEESSEESRSSEERSEEESEESEEEEEEESESSSESSSSESEEEEEESESRRESESSEESSSSSSESEESSESSSSSSSSEEESSRSERSSSESRSSEESSSSERRSEESEESSSRERSSESSEEESSSSSSEESESERSESESSEESESEESSEESESERRSESESSESSSSSESEEEESSSSSESEESSSERESESESRSEERRSSSEESSSEESSEESEEESSSSRSS
SSSSSSSSESEEESEESSSESSSSRRESEESEREEESESSSEEESSEREESREESSEESSSESRERESSSEESESSSSEESESSESRSSSSSSEEEEEERSESESSRESESSEEESSERSEESESEEESRSSEEESEESESSSSSEESSSESSSSSSRSSSERSSSSSSSEESSSSRESSRSRSESSESESESESSSSSSSSSSSSEESSESEESSSSSESEEESSSEERSEESESSEESEESSSEESSRESSESESSSESSSSSSESSESSESSSSEESESSESSSESSERRESERESEESSEESRSSSEESERESSESEEEESEEESEEESSSSESESEESSSSSSSESESSEEESESEESSSSSESERRSSRSSSSSESERESRSESEEEEEESESE
EEEESSSSRSESSRSESSEESSSEESSEEEESSESRESSSSSSESSSSEEEESSEEEEESESEEESESESESERSSSSEEESRSRESEESSSSSRRRERSSEEESSSSESEESSSSESSESSSESSSESESSSESERESSSSSESSERSESESESEESSSSSERSSSESSESSSEESREESEEESSESSREESEESERSESEESSEEESESSSSSSSSESSEEESSESSRESESSSRSSESSSSRESEESSSRESESSSSSERSSESSESSSESEEERSSEEEESSSESRESRESESSSSSESSERESSESRESSEEEEEESESSRSESSEEEESERSSSSSESSSSESSEEEESESSEESSSSESEESEESEEESESSSEEESESSSSEEERSSSSESE
ESSESESESESSRSSSSERESSEESRSESSSESRESESSESEESRSSSSSESERESESSEERSSSEEESSSSSSEESSSRSSSSSEESESEERSSRSESSSESSSSEEREESSSESSESSSSSSEEERSERESSESESESESSSESSSESSSSESSEEEEESEEERSEEERRESESSSSRSSERESESSSESSSESESSEEESSSEEEEEEESSRSSESSSEEESSSSSSEESSSEEEESSRRSSESSSSSSSSSSSSRSSSEESSRSSSSSESEESRRRSEEEESRSESSESESSESSEESSESESESSEEESEEESRSSSSSSRSSSSEREEESESSERSRESESSESSEESSSSSSEEESESSESSRSEESSSSSSEEERSSSSEEERESESESSSS
SEESESESSEEEESEERREESSSSSESSEEEEESSRSSEEESEEESESSEESSERSESSSSSSRSESESSESSSSSSEEESSESESSSESRRESSESESRSESRSSSSSESSSESSEREEESSSSSSESSESSESSSSEESEEESESSSSESSSSSSESSEESSSREEESSSESSEESRSSSEEEEEEEESESEEESSESSEERSSESSSSESESREESSSREERSSEESESEESRERSESESESEEEEEEEESEERSEESSRERESSESSEREESRSSSSEESESRSSEESESSSESSEESSSSESSSSSESSESESSESESRSEEERESSSESESSREERSSSESSSSSESSSSSESESESSEERESEESSESSSEEEESSEEESEESESESESEERR
RESESESEEESSSSESESSSSREESEEEESSSESEEESESRSSESEESEERESSSSERSREEESESRSSEESEESSSSSESEESSESSEEESESSERSEEESSRSESSESSSSSEEESESESESRRSESSESESRSSESSSRSSRSESSESSSESESSSSSSSSEESESEEESSSEEREESSEESESEESESEESEEESEESESSRESSERESSESSEEESSSSSEERSSESESESESRRRSSSSSESSEESESESESSSSSEEESSESESSRSSERSRESSESSSESESSSSESSSSESSESEESSSESEESSEESESEESESRSEESEERSSSEESSREERSESSSEESESSSSEESSEESSESSSSSSSSESSSSERSSEEESSSEEEEESESEESS
EESSSSSSSESEESSEESSESESSSESSESESSSSEEEESSSSERSEESSSRSERRESESESSEEESSSRSEERSSSSESESESEERSSRSRSSESESSESSEEEERSEESSESEESESEEEEESSSSSSSSEREESSERSEEEESESEESESSEEEESREEESSSESSSSERSEESSSRRSSSSSSSRSSESSSSSEEESSESSESEEESERSSEESSEEEEEERSSSESSSSESRERESEESSSSRSSESEESSSSSSSSSSSRSSSESSESSESESRSSSESESSSRSESSSSSSERSSEESSSSSSESEESSSEESRSERSSSSSSESSSSSSSERRSSEESESSEESRSSESEEEEESSSEEEEERSESESSSSSEESSSESSESSEESSESSSS
SESSSSESSSSEEESSSEESSESEEESSSSSSSSERSSESSESSSSESEESSESRSSEERSSESSSSESESSSRSEEESSSESEESEEEEEESEESSEESSSSESSESSESEEESEEESESESSRERSESRESSSSSSRSSSESEESEEESSSSRRESSSSRRSEERSSEEESSSSESSEEEESSSEEESSRSSSSSEEESESRSESSERSSSSSERSESRSESSSSSSSSSSSSSSEERESSEESEESSEESEESSESREEESRSESSRSRSSSSRSESSESESSSSRESEEESSSEESSSERSSESSESEERESESESERRSSSEEESESSESESSSESEEESESESESRSRESESESSRESEESESEESESSSSRESRESSSRSSSSEESSEESESE
RESSEEEESESSESESEEEESSSRSESSSSRRSSSSSEERSESSESSEESSEEESEEESESSSSSSSSSSSESSSEESESSSSSERSSEEESESSSEREESSSRSSESEEEERRSSSSSERSRERESRSSEESSEESRESERERESSSEERSSSERSEESSEEESSESSSSSSEEEEESESESSSSSESSEERRSSRSEEEESSESESRESEERSSESSSRSSEESSSSSESSEEEESESSESESEEEERSESEESESEESSEESESEEEESSSSSSSSSSSSSEESRRSEESEESSESSEESSSSSSSESEESEEERSESRESRSSESSSSESSSSRSERSEEESSSESESESESSSSSESESEESEESESEESSRESSERSSESRSSSSRSESESERE
SESSESSEESSSSSSESESRSEEESRSEESRSSSSRSESESEEESSSEEEEEERSSSSSSESSESSSESRSESEESSSSSSEEERESESSEESEERSRSEESSSSSSSSSESSSSESSSESESSSSSSSSSSSSSSSRSSEESSESESERSSSSSESESEEEERESSSEESSSSESSSESSSESESRSSEREESESSSSESSSESRSSSSESSSEESSSRSEEEEEERSESESSEREEEEEESSESESSRSESEESSSSESESSSSEEESEESERSSESESSEESSSSSSEESSRESEREESESSSSRESSSSSSEEEESSERSSSESESESESSSSRSSEESEERSESSSSESREESSRERSSERSSSSSESSSSERSSSESERSESESRSSESEESSS
