                                                                                                                                                                            *|*       ***                                  ***   ***  *|***    ***           ****  *|*|*               ***           *|*                                 ***                        ***                ***               ****   
                                                                                                                                                                            *|*       *|*                                  *|*   *|****|*|*    *|*           *||*  *|*|*               *|*           *|*                                 *|*                 ***    *|*               **|*               *||*   
                                                                                                                                                              ***           *|*       *|*         ***                ***   *|*   *|*|**|*|***  *|*     ***   *||*  *|*|*    ***        *|*           *|*                                 *|*         ***     *|*    *|*          ***  *||*  ***          *||*   
                                                                                                                                              ***             *|*           *|*       *|*         *|*                *|*   *|*   *|*|**|*|*|*  *|*     *|*   *||*  *|||*    *|*        *|*           *|*    ***                          *|*         *|*     *|*    *|*          *|*  *||*  *|*          *||*   
                                                                                                                                              *|****          *|*            |        *|*         *|*                *|*    |     |*|**|*|*|*  *|*     *|*   *||*   |||     *|*         |            *|*    *|*                          *|*         *|*      |     *|*          *|*   ||   *|*           ||    
                                                                                                                                        ***   *|**|*          *|*            |        *|*         *|*                *|*    |     | |  |*|*|    |       |    *||*   |||      |          |             |     *|*                          *|*          |       |      |            |    ||    |            ||    
                                                                                                                                        *|*   *|*||*         - |  --     - - --   --  -| -  - -   -|       -- - --  - |    --   - - |- |-| | -  |  - -  |    -||    -|-   ---|      -   --  -- -  - - | -- - |--       -    --   -        |  --- --  -|-     --  -   |  --      - |   ---  - |   -  --  - --    
                                                                                                                                        *|**  *|*||*         E-|--ES-- --E-E-EE - ES- E|-S -S-S --E| -  -- EE-E-SE -E-|- --SS---E-E--E--S|-- E-----E-E----  -S||-- -E-S---ESE- -  - S  -ES--SE-S--E-S---SE E |EE---- --E-  -EE---E - -----|  EEE EE--S-E---- EE- E- ----SS-  ---E --- ESE--E-- - S- EE--S SE  - 
                                                                                                                                        *||*  *|*||          EE-EESEER-ESEEESEE-S-SES-S-EE-EEEE-SEE--E--EE-EREEESE-SES-E-SSSSESESSSSSESEE-SE-EEEESSSSEESSS--SS--ES-SESESSEREES-E--R-E--ERREESSSSSRSEERERRS-E--EEESEE-EREE--EESEESE-E-ESEEE---EES-EEERSEEERSS-ESE-ES-SSEESEE--SESE-ESE-SESEEESE-E-SE-ERERS-SR--R-
                                                                                                                                        *||*   | ||         -EESSSSEESEESSEEEEEEEESEESSESESEEEESREEESEESEREEESEESSSSEESSEEESEEESSEEEEEEEEEEESREEESRSESESEEEESEESSSESESESSSEEESEEESSESEEEESESSESESEESERSSSSEEESSEESERESSSSESEEESSEEEESESEESSSSSSEEESSEEEESEEEESSSSSRSESSSESESSEESSSESEEESSRESEEEESEEEESSESRSESSSE
                                                                                               ***                                       ||   -| |-        -SESSESESESRESSEEESSSERSERSESESESEEEEEESESSEESSESESSSRSEEESRSEERSEESSSERESERESSERSSRSREEEEESEEEESEEEEEEESSSSEEESSEESESSESEESESRSEESEEESEEEESESEEEESEEEESSSREEEESEEEEEESSEEEEERESRSESSSEEEEEEESESSEESESSEESESSSREEEEEREEEEESESEEEEEEEESSESESSSSSSESESE
                                                                                              **|*                                       || --S- -S-     --SESSREEESESRSEESERSEEESRESESEESSEESSSEESEESEEEEEESESSESSEEEESEEESEESSSEEESSESEREESSRSEESESEERSSSERSSEESEEERSEESSEEESSEESEEEESEEERSSESSESSEEEEERSESESSSEEEESEESESESESSEESEESESSEEESESSEEEEESESRSSREEESEESEEEESSSEESEEESESEESSESEREESSSSESESEEEESSEEERS
                                                                                 ***          *||*                                -     ----SESE-SEE-----ESESESRESSSSREEEESESEEEEEEESEEEEEESESRESESSSEEESEERESSESEEESERSEESEESSREEESREEESESSEEEESSSESSEESESESSSEEEESESEESESEESSSRSESRSSESSSEESEEEEREESSESEESSSRESEEEESEREESEEESSSSSSSEEESERRESEESEESSEEESEEEESSEEESSEEESSSESEEEEEEEEEESEESERSEERSSSEEEESESSEEEES
                                                                                 *|*          *||*                      ---  --- -S-- --EESEEEEEEEEEESSESSESSESESEEEESEESESESESEESRESSSSSSSSESEEESSSESSESSRSEEEESSEEESSESSEEEESEEEEEESESSSSSEESEESESSESEEEEESSSSSESEESESSEESEESEESEERSEESESSSEESESSESSEEEERSEESSSSEESEEESESEESSSESSEESESSERSEEEEESEESESEERSEESEREEEESSERSSSRESSSESRESEEESEEEESSEEEESESEEEESSSEEE
                                                                          ***    *|*          *||*                     -REE--ESE-SSRE-SESREEESERESEESREEEEEEEEEEREEESSSESEESESEESEESEESESSSSSEESSREEESERSESEEEEESSEESEEEEEEESEEERESSESESEEEESESSEERSSESEEREEEEEEESESEEESSESEEEESEESREEESSSEEEESESSEREEESSSEESEEESESSEEESSESESESESSEEEESSEESEEEERSRSESEESEEEESESSEESESEESEESRSSEESSESEEERSEEEEEEEEEEEERESEESSESEE
                                                                     ***  *|*     |           *||*          -         -EEESESERESRESESEREESSEESEESESEEEEESSSSSESEEESSSSESEEREESSESSEESESEEEESEESSEEEESEEEESSRESSEEERESSESESSEEEEESSSEESEEESSSEESSESEEEEESSEEERSESESESREEESESSSERRSSEERSEESSESSESESEESSEESEEESESSSEESEESESEESSSSEEEREEESEEEEESSSEESSEEEEESSSSSESSEEESEEEESRSEESSEERSEEEEEEREEEEESESEEESESSEESESEE
                                                                     *|*  *|*     |            ||       - --E-----  --EEESRESSEESESESSSSSSEEEESSRESSEESEEESRREEEEEEEEESREESESESEESEESESSEESESESSSERESSEREESESESEESESSERSSSSREEEEEEESESEESSEESSEESEEESSEEEEESSSSESSEEESESSEEEESEESESSREESREESESEEESSRSSSESSSESSEEESRESRSEEEEESSESSSSEERSSERSREEEEREEESSESSESESSEEEESEEEEESSSEEERESSSESSSESESSEEESSEEESSSREESSRSRS
                                                                     *|*  *|*     -            ||   -  -E-EEEEEEES--ESESSESRESSESESESEEEEESESSEESEESEESESRSSSSSEESSSERESRSSESEESEESESSRSESSSERREESEEEEESEESSESSESSSSEREEESSERSESESESSEEEESSEEESESEESESSEEESEESEEEESEREESEEEESEEESEEEEEEESESESEEESSSESEESEEESSESSESESEEEEEEESESSESEESEEEESSEEEESSEEEESEERSSEEEEESESSEEERERSSESSESSEERRESESEEEEERSESSSEESSESESSESS
                                                         ***         *|*  *|*   --E-  --   -- --- --S--ESSSEEREEESEESSESREEEEESEEESSSESRSEREESERESEEEESSSSEEESESRESREEEESEESESSESSRSRRSSEESSESEEESSSSSSESEESSSSEEEERSESESESESESSEEESSREESERSSSRSSSSEEEESEESEEEEESRSRSESSESSERSSSEESSSEEEESESSEESSSSESESSESSESSSSSEEESESEERSEEEEESEESSEESSSERSEESSEESEEESSEESSSRRSEEEESSRSEESESEESSESSESEESSSESEEEEESSSSSSESSEEEE
                        ***                             **|*         *|*   |  --ESSE--EE---ES-ERE-EEESSSEEEEEEEESEEEEEESSESEESESSSSESEEEEEESEEEESESSESSSEEESSEESSEESSESSEESESESESESESSSEESSSSSEERERSEERESESSREEREEEEESSSEEEEEEESSSEREEESEESSESESEEESEEERSSESSESESSESEEESSSSERSEESREEREESESESEEESSEESSEESESSEEREEEEEESESEESEEEEEEESESSESRESEESESSSESSSSESESSESEESSEESEEEESSEEESSEESSSESESEESSESEEESERESSSESSSESES
                        *|*                          ****||*         *|*  -|--EESSESESESESSSSEESESEEEEEEEESSSSEEEESEEEESSSSRSEEESSEEEEESESSSESSREEERSSEESSRSEESERESSSSEESEEESSSSESSEEESSEEEEEEEESSSSEESSSEERRESESSSESSSSSESEEESSEESEEEEEEEEEEEEEESESSEEEEESSSREERSSSSESSEESSSESSSEESESEEESSESEESEESSEESSSERSSSEESEESRESESEEESSSEEEEEEESSESSESESRESESESSEEREESESSESSREERESSSSSSSREEESEESEEEESEEESERSEEEESSESSEEES
                        *|*                          *|**||*          |  -S-SSSSSEESSSSSSSESEESSEESSESSEEEESSEEESSEESSRSRSSEEREESESESEEEESSSSEESSSEESEEEERSREESSRSRSESSESSSSSESESSSESREESSESSREESEEESEESESEEEESSSSEEEESESSRESSSESSEEEEEESSRESEEESSEESSESEEEEESESSEESSSSSSEEESEESEESSSEEESEEEEESSSSESSRESSSESESEESESSESSSESEESEEEEEEEEEEEEESERESSSESSSEESESREESEEEESSSSSSEESESSESESSSEESSESEEERREERSSESEEEEESSSSS
                        *|*                          *|**||*          | -ESEEESEEREEESESSSEEEESSESSEEEEEEEESESEEESSSSESREESESSSSSRESESSEEERESEEESEREESESSEERSSRESESESSEESSSRSEESESESESESEEERSSEEERESEEEEEESREEEREREEEEESESEESSEESEEESSESEEESEEESSSSSSEEEEESESESEESSEEESESSSESEEESSSEERSEESEEESEESSESEESESSEEERRSEESESEESSSREEERSEEESEEESSESRESEESESESSRESSEESEEESSSESREEESSESSESSSSESERESSSREEESSSSERESSESSEEEEE
              ***       *|*                          *|**||*       -  --SSSESEEEERSESESSEESEESESSRSRSESSSEEESSSSSEESSSSESSESRSRESSSSESSEEESSESSESEEEESSSEREESSRSSEEEEEESEEEESSSRSESRESSSSEEEESSSEEEESEEESSESEESSEESSRSSERSESEESEEESEESSSEEEREESSEEERESESSESEREEESEEESSESSEESERSSSEREESESSSRSEESRSESSEESSSEEEESESERSSSSRESRSSEEEEREEESESSESSESEESESSESSESESSSESSSSRSSERSSEEESSESESEESESSEEESEEESSSSSESEEEEESRSSEE
      ******  *|*       *|*                          *|* ||   -- --E--RSSESESEESSSESSEEESESEEEERSEESEEEEEESSSSSESESRSRSSRESSRESESSSEESSESSESSSESEEEESESSESEESEEESSEEEESSRSESEEEESSEEEESESSESSSESSEESSEEEESESSSSSSESESESSSSESEEEEEESSEREERESEESSSSEEESEESEEESSSSESSSESSSSEESESRRSRSEESESEREESESSESRSSESEESESSSEEEEREERSESSEESEEESSESEEERRESRSEESSEESSEESSSSEESSESSSRSESSSEESSSESSSSEEESESEEEREEESEEEEEESEEEESSEEE
      *|**|*  *|*        |                            |  ||  -EE-SESSESSSESSEEESESSRREEREESEEEEEESRESEEEESESSSESSESSEEESESESSSEERSEESRSESSEREEEEESERSSESSSESEEESSSEEEESESRSRSSESSSERSEEREREEESESESSEEESSSESSESEEEEEESEEESEERESESRERSEESSSSSESESESSSERESESESSESSERSESSSREEESSEEEESESRSEEESSESEESESRSSESESSSSSESERESSSSESSESRSEEEEEESSESESSRSEEESESSSEREEESESSEEEESESSEESESESESEEEESSEEEEESSEEEEEESSSEEEESESSEEESE
      *|**|*  *|*        |                            |  ----ESESSEESSEEEERSSEEESSSSEESSRSESSEEESSEEEEESSSEEESEESEEESSSREEESEEESSSSESSESSESESSESSESESESSERSEESEREEESEEEESSEESSSESSEERESSSESSESSEESSSSEEESESSSESESSSEEESESSSSSSEEERESEESSERSESSSSEEREESSESSSESERESSERSSESSESESSESESESEEEERESSEEEEERRSRESSSERSEEEEESESESSESSEEEESESSEESSSSEESEERESEESESRSEESEERERSESSEESEEEERESSESSREESESSSSESESSERSSESSSSESSESEEE
       | *|*   |  ---   --     --- -----              ---ESEESEEEESESESSEESSSESSSESREESSSESESEERSESRSSSSEEEESSSERSSSESSEEESESESSEESREEEESEEEESSSSSSESESESSSSSSSEESREESEESESESERESSSRESREEESSEESEEEERREESSRSESSEERSEESSESSEEEESESSESESSESESESSESSESSSEEEEEEESSESREREEEESESSRESSSEESESSSEESEEESESESSEESESRESESESSRSSSEESEEESESSESEESEEEERSESESEEESESESESSEEESRSRERESESEESESESSSSEESSEESRESEEESSERSSREESREESESESESE
       |  |  --| -SES- -EE-----ESS-EEESE----    ------SESEESESRSSSSEESEEESESREESESRSSSEEESSSESSSESSEESEESEESEEESSSEESESEESSEESESEESEERSSESEEEESESESEESEEESSESEEEESESSSSSSERSSSESRSSSSRESSEEEESSREEESSESSESSEESRSSSSSSSSSSSEEEESSSESESSSEESSEEEEESSRSESSSEREEEESSSESSSSESSEEEEEEEESSEESSSSSEESSESSSEEEESSESEESSSEESEESSSSSSSEEEEEESESEEEEESSSEERSSSSSSESERESEESESEEEESESESSSEREESSSESSSEEESESSEESRSESSSEESESEEEES
       -- | -EE--EESSS-SSSEEESEREEEESEESESES----EEESSESSESEESSEEESSEEEESSSEEESSSRESEESSESESSREESESESSESESESSSEEEEEEEESSSSSSESRSRESESEEEEESSESSSERESSRSSSSSSSESRERESSEEERESSSEESESESRSESSSREEESSESSSESERSSRSEESSEEEEESRSSSSREESESERSERSSEESESESESSSESSESESESSESSEESRESESEESRSSSEESESEEESEESEESEEESSEESESEESEESSSSEEEEEESESEEEESESSEESRSESEEEEESEESESREESEEEESESESEEEEEEEESSEERSEESESSSSSEESSRESESRRESESEEEESEEEES
      -SE---ESEEEESSEEESESSSRSSSESSSSEEEESEEESSSSEEEESREESSSESESSESSEEEESSSSSESSEEEESSEERREESSEEEEEESSSEESSSESSEEEREEESSSESSSSSSSSSEESEEEESESSEEREEEREEESSEERESRSRSESSESSSERSSEEEEESSESESEEESESSSSSSRSSSSSSESEESRSSSSRSSEESSSEESESSREEEESESSEEEESSESSSSESEESSSSESSSSEESESEEEEESESESSSEESSSEEESSEESSSSSSEESERSSEREESEESSEESESRSSSESSESRSESESERSREEESRSSEESSREESEESSSEESESRERERSEESESSESSSEESEEESEEESSSSEEEEREERES
  ----EESSEESSESERSSEEESSSSESEESERSESESSEESSSSSESERESEEEESESSSSRSSSSESEEEEESSESESEEEEEESESSESSSSERESSSERSESSRESSSSSSESRESSSSSRSESESSESRSSSERSSESEEERSSSSEEEESSSSSEESREESSSSSEESESREEEEESSSSEESSEESSSSSSSEERSEESESSSSSERSERSESRSSSSESSSESSESSSSSSESEESESRSEESEESSRSSESEEESEESEEESEERSSRSSESSSSESSESEEEEESEESSEEESEEEESEESRSSSSSEEEESEEESEESSEESSRESERSEESSSESEEESEESESEEEEESRRSSEEEEERSEERSESESESEESRRSSRSSSESESS
--ESSSEEESESSSERSSSSESEESSSESSSSESRSSSESSESSESSEREEEEEESRSEEEESEREEEESSSSESERESRERSSESSSSSSESERSESSSSEESSESRSSEESESESSEEESEESEEEEESSESESESSESESEEEESSSEEESESSSRSRESSSESESSEREEESRSRSEESSESSSEEESSESESSEESESESSEEESSEESESEEESSESEESSSESESEESESEESSSEEESESSSSSSSREEESSSEEESSERSSESESSSESSESSEESEESEESESESRSSESSERSSESSREEEESSESSEESSSESSESEESSSESSSRSSSSRSESSSESEERSSEREESSERSSSSSSSSEEESSSESEESESSEESSSEERESSSESE
RSEESRSRSSESSEESEEEEEEESSSEEESEEEEEEESEESRESESEERESEESRSSESEEESEEESSESSSEESSSESSSEESESSSESESEESEESSSESSRESSSSSSSERSEESSEESESEEESSSEEEESESRSSERESSSESESSEEEESSESSERESESSRRSSSSSSSEEEESSERESSSEESSSSSSSEEEESSESSSESSSSESSEEERSSSRSSESESSSESRSSESSEESEESERSESESESSSESESESSSSSRRESSESEEESEEESSSESEESEEESSRSESRSSSSESSEEERSSSSESEEESSEEESESEESEEEEEESRESSSEESEEESERESESEEEESREEESSEEEEESSSSSEEEEEEEEESRRSSSSSSSSESESS
SESSSSSERSREEESSSRSEESEEESSSSRERSESSSSEEEEESESSESESEEEESSSSSSEESEEEESSESSSREESEEEERSESSSSSSESESEESSSESEESSERESESSSESSSESRESSRSSSSSSEEEESSSSSSSEEESESSSSSSSSSREEESSEEEESEESSSSSSERSSRESEESEEEESSSEEESRSSESSSESESSSSSSSSSEESEEESESSSESESSSSSSSESSESESEEREEEESSSSSRESESEEESESSSSSEEEESSESESESESESSRESSEESSSSSRSESESERRRESESSSESEESESESSSEEESEESESSESESSESESESESSESEESSSSREEEEESEESEESSSESESREESSESEESESSSERERESSSSS
EESSEESEESESSESEEEERSERSSSEESSSSEESEEERESEESSSESESEESEEESERESSSSSESEEEESEESEEESSSSSESEERESEEERSESRERESSEESESESSRSSSSEESSESRSERRSSSSESSSSESSERESSESESSRSEEESSREERESEEEEEEEEEEEESSEEESEEESRSSSSEESSSSSSSSESESRSSSEESSESEESESESEESEESSSSESSEEEERERSEREESSSSSSSRSERESSESSEESSRESESRRESSEEEESRSEEESSSSERESSSSSESEREESEEEEESESSESSSEESESSSSESSSRSEEESSRSEESEEEESSSSEEEEERSEREEESSESSESSSESSSEESSESSSSSSRSEESESRSSSSSES
ESSSRESESESSSSESSSSSRSESRESRSESEEESSESSSSEESSEERESSSESSSSSESSERSESESEEESESSERSESERSRSRSEEEESSEESESSSESESRSSSSSSSRESSSESSSSSSESSSSSSSESSESSESSEESESEESEESESESRRSRERSEESSSSSESSESSSERSSREESSEEEEEESSSSSSESESSESSSESEEEEESRESSRSSESRSRSESESEERSESESESSESESEESSSSSESERESSSSRSESEESSSEEESEESRSSSESESESEERSEESSSSSESSSSSESREEESSEEESSEEESEESESSERSSEEEEESSERSSSSSSRSSESESRSSSSESESSRSSSESSSSEESSSSRSSESESSRSSEEESSEEES
SSSESRESSSESSEEESSSSERREREEESERESESESEEEESSEESSSSREERSSSESSESESSSSEEEESESSRSESSRSSSESESSERERESSESESSESSSSESSESSSESESRSSSSRSSSESESSSSSSSRESSSSEESSESESEESSSEESEESSESSSSESRSESSESESSSESEESSSSSESESEESERSSESSSEEESSSRSEESSSSSEESSSSSSRREEESSEEESSSESSSSESSESESSSSSESSSEEESESESSSERSSEEESSSESESRESRSESRSSSSSRSESRRSESESESSEEERSSSSEEESEEERSSERESSSERESEEEESESSESSSSESEEESESEEEEESSEESEESESESSSSSRESSESESESEESESSSEEE
SESSEESRSSSESSSSEESSESSRESSSRESSSSSEEESSSERSSESSESESESSSESESESSSEEERSSSESSSERSSESSEEESESESESSSSSSSSESEESESSEESSSSEESESESEESSSSSSSREESEESEESSEESSEESERSESSSEESSEESESSESRSSSESSESSSSRSREESSESESESSSSSESEESESSESSERSSRSSSSSESRSESESESEEESEEEEESEESSSSESSSEEESESEEEERRSREESSSSEEESEESSESESESSEESESSSSESSSEEESSSSSSEEESSSSSSESESREEEESEEESSRSESESSSESRSSSESSSEESSSEERESESSESSSEESSESESSSESSSRESEESESEREESSESSSEESESSE
ESSSESSSEEERRSESESSEEESRESSESSESESESSESSRSEESSSSSRSESSSSSESSESSSSESSSSESRSSESSEESESSSRSSESRESEEEEESSESSSESSESSSEESSESESEESSSSERESESSEEESEEEESESEESERSEESSEESSSESSESESSSEESREESSESESREEESSSSSEEESSEESSSEEESSESSSSSSRSSSSSSSESSSSEESSEERSSSRSRSESSSERSESSSSSSESSESESSEERSSSSEESSSSESSEESSSESESSESSESEEEEEESESEEEESSERSRSSERSSSSSEESSSSSEEESESEEESSSSERSREEESESSSSSSSSERSSSESSSEERESSESSEEERSSEESSEEEESEEEESESSSSEE
RSESRSSRERSEESSSESESESRSSRSSSSSSSSSESRSESSSSEESSESEEEEERSREERRSSSSEEREEESSSSSSSRESSESSSSSSSESSSSESESSSSSSSEESRSESEESEESSRSRSSESRESSESSSSESSRRRESESRSSSESESSSESSSSEREEESSESESSEESSSSESSESEERSSSESRSESSEESSSSSEESESSSSSSSEESESSRSSSEEESEERSSESSSSSESSRSERESSESESESSSSEESRSSSSSEESRSESSSSESEESSSSSSERSSSSSSSSSSESSSSSSSSSSEESSSSRSRRSEESESSRSESSSSSESEERESEESSSSSSSSSSESESSSEESSSSSSSSSSSSESESESESSSSRSESESERSEESEE
