                                                                                                                                             *|*                            ***              *|*        ***      *|*    ***                                                                                            ***                                                                                      
                                                                                                                                             *|*                            *|*              *|*        *|*    ***|***  *|*           ***                 *** ***                                 ***                  *|*                                                    ***        ***              ***   
                                                                                                                                             *|* ***                        *|*              *|*        *|*    *|*|*|*  *|*        ****|*                 *|* *|*                                 *|*  ***             *|*                                                    *|* ***    *|*      ***     *|*   
                                                                                                                                             *|* *|*                        *|*              *|*        *|*    *|*|*|*  *|*        *|**|*                 *|* *|*                                 *|*  *|*             *|*                                                    *|* *|*    *|*      *|*     *|*   
                                                                                                                                             *|* *|*                        *|*               |         *|*    *|*|*|*   |         *|**|*                 *|* *|*                                 *|*  *|*              |                                                     *|* *|*     |       *|*      |    
                                                                                                                                              |  *|*                         |                |          |     *|*| |    |          | *|*                 *|*  |                                  *|*  *|*              |                                                      |   |      |        |       |    
                                                                                                                                          -  -|-  |     -    - -       -  -- |  -    -       -- --   --  |-    -| --|-  -- -- ---  -|  |   --        -- -  |-  | --           --- -- ---- - -   -  | ---|  -            - - -- - -- -  -       -  --   -  - -               -  |-  |    - ----    -|  - ----   -
                    ***                                                                                                                 - S--E-E- |--- -E----S S------ S--SE-- -E -- E--- ---SE-ES---ES --S--- E| SR-S--SE-EE-ESE--E---|-- ES -  ----SE-E--|E----SE----  -----ESR ES EESE S S---R- | ESE|--S-------    -R S-SE-S-SE-E--E----  -E--EE---S -E-S ---- - ---  - S  -E- -----S ESSS  - S- -E SERS - S
                    *|*                                                                                                                 E-SSEERSS--SEE-EEEESEE-EESEESS-SEEEEEE-ES-ER-SEES-EEEESSSEEESSS-SESSES-S--SSEESSSSSEEESSSEESESE-EE-SR-S--ESSRSSSERE-SEESESEESSS--SEEEESRE-EE-SEEE-E-ESEESS---ESS-EERSSESSEE----SS-EEEESSSESSSRSEESEE--ERSESREEEE-REEE-SSSR-S-SEE--E-E--SSE-EESEES-SEEE--S-ER-EE-EEES-E-R
                    *|*                                                                                                                -ESSSESESEEEESSRESSSESESRSEEERESSESSESSSSSEEEEEEEEESEEESSESEEEEESREEESSSSESSESSESESESEEERSEREEEEEEEESSSEEEERSESSESEEESEEESSEEESESSESSSSSSSEEESEEESESEESSEESSEEEEEEEEEESEEESSEERSSESSSEESEEEEEESEEEESESSSSERSEEERSSESSESSEEEESSEESSESEERREEEEESESSSSESSSSSESEEESEESRRSSESS
                    *|*                                                                                                              --SEESEEESEEEERSSESSEEEEEEEEESEESRSEEEEEREESSEEEEEEEEESSSSESESEESSEESRESESEESEEESESSSESSEEESSSEEEESESSEEESESESSRSESREEEESSESEEESESSRSRSESESESEESSSSESEESSSREESEEESEESSESSEREEESSESSREEEEEEEEERREESSEESSEEEEESSSSEEESEERSEESSSSREESSEEESSSSEESSSESSRREEERSEEEEESESSSEEEESESS
         * *        *|*  ***                                                                                         ***            -ESSRESSEESSEESSSSSEESEEERESEESSESSSESEEESSSESERESERSESSSSESEESRESEEEEEEESEEESEESSSESSEESSESSSSSESERERESSREESSSEEESSEEERSEESSESEERSSRESSSSRSEEEESSEREEEEERSESSEEESSEEEESSEERESSEEEESESSEREESESEEEEEEESSEESESSEESESESESESESEEEEESEEESESSESSEEEEEESSSSSEREESSEEESSEEESEEEEEESS
         *|*        *|   *|*                                                                                         *|*           -SSESRESESSESREEEESESEESSRESSESSESSESESEEEESSSSSSEEESEEEEESEEESESEEESEESSEEEEESSSESEESEEESESREEESSSEESESSERSSESSEEEEESEEEESEESESSESESEEESSEEEESEESEEEEESEEEESEESREESSRSEEESEEEESERESSSSSSEESSSSEREEESEEESESESSSSSRRSSSEEESSEERESSSEEEEEEEEREEESSESEESSSEEEEEEESSEESEESEEREEEE
   ***   *|*         |   *|*                       ***                                                               *|*         --EESSSESSSSSEESSESREEEEESSEEESEEEEEREEESRESSEEEERESSSSEEEEEEEESESSSSEEESSESEEEESSEEERSESRSSSSEEREEESSSEESSSEEEEESSESEEESEESEERSESEEESEESEESSSEEEESSEEEEREEESEERSSEEESSSERSSSSSESESEEESEEEREEERERSEEEEEEEERESRSSSSEEESSSEEEEESREREEEESESEESSSESSESEEESSSESESSRESESSEEESSEEEEEEE
   *|*    |       - -|    |                        *|*                                       ***                     *|*        -SSESERSEEEEESSEREEEESEESEESSSEEEERSESESESEEESSSSSEEEESSEESESEEEESSESESSSESSSESEESSESSESEEEEEEREEEEESESRSEESSSESESEEEEEESSSESEESSEEEEEESEEESSESSSEESEEEESSEESEESSESESSSESEESSEESEEEESSSREEEEEEERSSSEEEESSESEEEEEEESSSSESSSREEEEEEEEEEESESEEEEEERESSESEEESEEEEEESSEEESEESESESEEES
     *       -----E-S- ---|  ---       ***         *|*               ***                     *|*                    - |        -SEESSSEESEEEESEESEESEESSEEEERERESEESSSSEERESESEEEESSESREESEESSEESSEESSRSESEERSSSSEEESEESSESEEERSSESSSEESSEESSESEESESEESSEEESESSSEESSESEESSSSEEEEESEESEESSERSESESEESSEEESESSSEEESRSSSEEEEEESSSSRERSEEEESSERSEEEEEEERSSSSSESEEEESESSSESEESEESEEEESSERSSEREERSSESESEEERSSESESESRESS
    |     ---SSERESSEE-SSE---EEE-      *|*          |                *|**                    *|*                  --E-| -     -EEEERREESSSSESSEESSERESSEEEESEESSEEESSESSEESESSEESEEESEESEESREEESSSEESEESESESEESEESESSSESSSESEEEEESSREREEREESESSERERESEESEEEEEEESESSSSSESSESSSESEEEESSSSEESEERESSSESESESEESEEEESSESSSERESESESESREEEEREEESSSEERREESSSESESSSRESSEERSSESSEERSSEEREEESEESRSESEESESEESSSESESSEEESSESSR
  --|    -EEEEEEESSESESEEESSSEESE-     *|*          |  ---           *||*                    *|*                 -EREE--R--  -EEEEESSEEEEESEESEESESSEESSSSEESSEEESEESESSEESESEESSSEERESESEEESESESERRESSSEESEEEESEEEEEESESEEEESSEEEESSEEEESEEEEEESEEESESESEEESRSEESEEEEEEEESEEESESSSESSEEEEEESSRESESRSEEEEREEEESESSEERSERSSEEESSEEEEEESSSEESEEEESSSSEESEESEEEESSESSERRSSESEEEEEESSEEEEEERSEESSESSEESEEESREERSESSE
 -EE-----ESESRSESSESSSEESSSSEEESES-   - |          ----ESE--         *||*                     |                --RESSSSSSSE--REEEESEESSEEESSSSEEESSEEESSEEESSSSSEESSESEEEERRSESSSSSSRESEESSEESRESERSSSESESEERESSESESSRESERSSSRESRSSESSSSSESRESESEEESSSSSEEESEERSSEESSSESESREEREEESESSESSSSEESESSEEREESSSRESEEESSSEEEEEEESSSEEEEEESEEEESSSEEEEEEEEESSSRSEESSESEEEESESSSESSSEEERSESSEEEESEEESSERSSSSERSSEEEEEEEESE
-EESSRESSSESSSEESEESEESEEEESSSESSES---E-|       - -SEEEESESS----      ||                 - -- |           --  -EESSERERESEESEESSEEESSSSESEERESEEESESEEEESEEEESEEREEEEESSSESSSEESSEESESSSSSSSESSSSEESSEREEESESSSSEESSEESSESSESSSEESSSSESEESSESSERESESSEEERSSSSEEEERSREESSEESESSSEESESEESSRSEEESESEEEESEEESSESEESSEESESSESEEESEESSEESEEEEEESSSSSSREESESSESRREEESESSEEEEEEESESSEEESEEEEEEEESSSESEEESRSEEESESEESEEES
EESESSSRSSEEERSSEEESSSEESSSEESESESEESESS-----  -E-EEESEEERREEEEE-     ||                -S-ES----   -- ---SE--ESSESESEESESESEESEEESEESESEERSEEESESEEEESRRESSSREEEESESEESRESEEESESESESSESREEEESSEEESESSSSSSESSSSESESSSSSESERSSSSSEEESSEESRSEESRSSEEEEEESEEESEEEEESSSEERSESERESEEESESSEEEESESESSESSSSESEEESESSSSRESEEEESSESSSEEESESESEEEESEEEEESSEESSSSESSSEEESREEESEEEERESEEESREESEESSSSEESSERESRSSSEESEREEEEESRE
EESEEEEEEESSSEESSEEEEESEEEEEEERESSEREESESSSSE--SEEESEEEESSSERSESS-    ---       --     -SSESEESSS- -ES-SRSEEERSSSSSEEEEEEEESRRSSRSSRSEESESRSESRESREESEESSSESEEESSEESSESSESESSERSEEESESSEEESSEEESEESSSESEEESSSEESSESERESEEREEESESSESEEEERERERSESEEEESSERESSEESESESSSEEEESSSEREESERSERSSESEEESEESSSSSSEESESEEESEESSSSEEESSEREEESSEREEESEEESEESSRSSSEEESERSEEESSSSESESESEEESSEESEESEEEESSRSESESESSESSSEESSESSSEESER
SESRSSSSESSEEEESSSEEESREEESSREEEESSRSESEESSSSSSSESESSSSSSSSESESESR----SSE-------EE-----SESEESEEESS-SSEESSEEEESEEEERREEESEESRESESESSSEESSEESSRESESESSESSEEEESSEESEESSEREESSERESSESESESESSESSEEEEESSSSESESEESSSEEEERESSEREEEESESSEESSSEESSESESESSSEEEEEEEESESSSESSESSREEEESRESEESSEESSESSESESESEEEESSSSESSSRSSSEEEESSEESRRESEEESESSSSSSSEESSEESEESSSEEESESEEEEERSEESEEEEEESSSEESESSERSERREEESEEEEEESEEEESSESSESEES
RSERESESESSSESEESSEEEEESESSESEEEESEEERSESSSSSSRSEEESEESESSEEEEREESRSSSESEESSSEEESRESESRESSESSESSESSEEEERRESESSSEEESESESESESSESSEEEEEESSSSRERESSESSSESSSEEESESSSSESESEEESRESEESEEESSSESERSSEESEESEEESEESSSRSESSEEEESSSEEEEEESEEEEEESESESSSSSEEEEESSESESSSEEEESSESSSSESEERREESSEEESSEEEEEEESESSEESSEESRESESSESESSSSERSSSEESSEESEERSSSEEESSRESRSSSSEEEESSSSSSEESESEESSEESSESESSEEEEEESEESESEEESSSESESESESEEEEEESSEE
RSEEEEESESEESSSSEESESSEESEESEEERSERSSSSEEEEESEEERESSSSEESSEERSSSSESEEEEEEEEEESERSSESESESEESSSSSRSSESESSEEEESESESESEEESEESESSEEEESEESSEESSSSRESSEEESESSSESEERESSSSEEESSRSEEEEREESSSSESSSESESSEESSESSSSESSEESESEEEEREESSSSEESESEERESERSEESSSEEEESESEEESRSSSEEEERSESESSERSESSESEESESSEESSSEESEESSSSSEEESSESESEESESSSSEESSESESSEEESESSSSEESEESSSSSSRSEEESEESSESSSEESSESESSSSEEESEERSSRSESSREEESREEESSSSSSSESESEESSSS
SEEEEEESESREREEESEERREESESSEESEESSESSSSSEEEEESEEESSSSESESSSESERSSSESSEEEESEESEESSESSRSSSSESSSSEESESSRSSERSESRSSSSESEEESEESSEEEERSSESSERRSSSESEESSSSEEEEESESEESEEESESESESESSESSEREEERESESSEESESEESEESEEEEESRESESEEESSEEESESRSERSSSSRSEESSEESSRERSSESEEESSREEEEEESESEREEEERSSEESSSESRESSSSESESEESSEERESREESSESSESSSRESSEESSSEEEESSSESESEESSREESSSSEESSSESSERESEEESSSSEREEESEEEESSESSSSSESSESEEESEESEESSSSESSERSESE
SSSSSRRSESESSRSSSESESSESEESSEEESEEESSESSSSSEESEEEEESERSEESSSESEEREESSSEESEESEEEESSSESSEEESESSESSRSSESESESEEEEESESSSEESEEEESEESESEESERESEESERSEEEESEESEEEERESEERSSESESSSREESSSSESSSEEEESESSEESEESSSEESESESESSSESSEEESSESEESEEEESSSSEESESEESEEESEESESSSEESSSSSSEESEEEEESESESEEEEESEEESSRSSEEEEEEESEESEEEEEEESEESSEESREESSREESEESSREEESESEEESEESSESERSSSEEESESEEESREESSSEESEREEEEESSSSEEEESEEEESREEEREEEREEESEESSSS
ESSESSSSSEEEEEESSESESSEEEESEEESEEESSSEEESSRSSESSEREERSSESESEEERRSESERSSSESESEESESEESSEEERSSSSESREEEEESSERSESEESESEEESESSSSSSEESESESEESSSSSSSRESESSSEEEESEESSSSESSESSREEESESSSSEEEEESSESESEEEESEESSESSEESSESSESSRRSEEERESSESSESSESSERESESESSESSESESRSSSSEEESSEESESSRSEESSSRSESSSEEEESESSEEESSEESESSSRESSESESESESSSEESESSSESESSSREEEESSEESEESEESEEEEEEEESERSESSSESESRSSSREESSSSEEEEESEESSSEERSESSSESSSEESEEEEEESSS
SESEESESESSSSSSSRESSEEESSSSSSESSSSSSSSESEESRSESSESSSSSESSESESEESSSESESEEESRSEESESSSSSSEREEESEESRRERSSESERSEEEEEEEEEESSESEEERSSESSSEESSESRSESESEESESSEESESEEEERSREESEEESESSSESSSSESSRESSSSSSESSESRSEEESESESEERRSSSEESSSEESSRSSSERSSEEESEEEEEESSSERSSEERSSSSRSSEEREESSSSESESSRSESEEESRESEEEREERSSESSSEESESEEERSEEEEEEEESRESSSESSSEEERERSSESERSEESSESSSSEEEESESESEESSEEESESESSESEESSEREEESESSESSRRSEESSSEEESEEESESE
ESESREESSESEESESEESSEEESSESESESEESSEEESEERESERERSEERSESESSSRSSEEESSSESESSSSERRSSSEESSSESESSSSERSSEREESSSSERSERSSESESSESESSESEESSSSERSESEESESSEESSESEESRSEEESRSSEESSSSSESSEEEEEEEREEESEESEESEESESSSSESESSSESESESSSSSSSSEEEESSSEESEESSEEESSSESRESEREEEESSESSSESESSRESESESESEESESSEESESESEEEEEEEEEESREESESESSESESSSEEESSESSSSEESESSESSREESESESSSSEESSSSRSSESESEERSESSSESSEEEESSSSSSSSEESEEREEEEEESSSESEESESSSSSSEES
RSSEESSESSSSESRESEREESRSESESSSSEEESSSSSSSEEREESSESRSSEEESESSSSESESSESSSEESSRSRSERESRSSESSESSSEEEEREESSSSSSSESESEEEESEESSSESESSESESSEEESESSSESSEEEEESEEESEESEEERESSEEEERSEREEEEESSRESEEESEEESSSSSSRERSESEESEESSSEESEESRSSESSEESSEESRSSEESSSSSSSESSESSSESESSERSESRSEESEESSSRSSSESRSEERESEESSEEESSEEESSSSSSERESESSSSRSEESSEESSESEEESSESSESSSSSSSSERESSEEEESSSREESSSSSESESESSERSEESESSSSEEEEESEEESSEESSSEERSSEEEEERS
EEEESEEESSSSSERSESSSSSSESEREEESESSSESSSSSESSSRSEERSSESSESESRESRSSSSSSRESRRESEESSSRSRESEEEEEEEESERSSSSEEESSSESSEERSESESEEESSESEEEERSSSRSESSESSSSEEESSSEESSEEEEESSSESESSESSSSSESSEEESESSSSSEEESSESEESSSEESSERSEEEEERSSSSEESESSSESSEEEEESESEESRSRESRERSSSSESEREESESEEESSEEEESRSESESSSSSSEESESSSSSSEEEEERESSSEESSSESESSEESESESSRSSSESESEEESSSSSSSSSERSEESSSREESESSSEEESESRSESESEEESRSRESRSSSEESRESEESEESSEEEESSSSEEE
SSSERSESSESSSESESSSSEESSESSSSESSSSSESEESEESEESSSSESSSSESSSESSESEEEEESSEESSSRSSSEEESSSSSESSEESERSESSSESSEEREEESESESESESSSSSSSEEEEEESSEESSSESSSSESSSESEERSSESSERSSSERSEERESSSSSEEERRSSSSESSSSERESSEESSEEESSSRSESERESESSSEESSESSSSRESSESSESEESRSEEESEESSEEESESSSSRESSSEEESSESSESSSESEESESSSSEESEEESEESESSRSSSSESSESESSRSESEESEEESSEESESESESSSSEESEESSSESESSSSSREESSSSESESESSSSSESESESEREEEERSEERSEESSERSEEESSSSESSR
SSSSSSSSEESSESSSREEESSSSSSSEEEESEEEESEESSSESESSSESSSSEESRSESESREESSSSRSSESESSSESSSRSRSESEESSEESSESSEEESSESRSEESSESSESSSSSEESREESESRESSEESREEESSRRSSEEESESESRESSRRSSSEESSSSEEERSESSSSESSSRESESSSERSSSSSEESEEERSESSEESEESSSESEEESESRSEEESEESESEERSRESSEERSSESEESESESSEESEESEERSSESSESRESESESSEEESESSSESEESESSSSSEESSEESSESSSERSSSSSESSEESSEEESEESSEEEESEESEESEESSSSEESSEESESSSSSSSSSSEEESREEEESEESSSESSSESSESERSRS
ERSSEEREESESESEEESRSSEEEESSEEESSSSEEESSESESSEESSEEREESSEESSESSESESSSSSSSSSSSSSEERSSRREEESSESEEESSESSESEESSSSEESERSESSEESEEESSESESSESESESSSSSSSSEESSRRREESEESESSESESSEESERREEEESSEEESEERSREEESEESSSSESSESSSSSESESSSESESSRSSESEESESEEESSEESESSSESEESSESEESSESSSSESESEEESSEESSESRESSEESSEESEEEESESEESESSESEESSSRSESERESSSERSSSEEEESESSRSESSSESEEERESEEESSESSSSESEESESEESEEESSSSSSEESSSSEESSESSSSSEREESESSSSSSSSSESE
SESSESSSSESESERSSREEEESESSSRSESSSSEEEESSEESSSSSRRSRSSSEESESSESESEEESSSEESSSRERSSSEEESESESSRSSSEEESESSSEERSSESESESSSSSEESSSSSRSSSSEESSSSEEEEESSSSESESRSESSSEEESERESESSSESEEEEESEEEESSEESEERSEEEEESSESESEEESESEEESSESESSRSSSESSSEEESESEEEESSESEEESSRSSSSERESSEESEESEESSESSSESSSESESSEESRRESESREESSSSSSSESESSSSSEESSSSSESSEESSEESSRESSSEESESESSSSSEEESSSESSSSSSESESESRESSSEEESSESESESESSESEESSSESEESESESESERSESSSEE
RSRESESEREESSSSSSRSESSRSESEEESSSSSSSSSESSSSREESESSSEEESSRSEESSSSEEEEESSRSSSEERSSRSESSSSSEESESSEEEESESSESSESESSSSEESEREEESESSESSSSESESSSSSESESSSESSESESSERSSSEERESEEEESSSSEESRESSESEESSSSSEESESREESREEESSEESSSSSEEEESESSESEEESESSERESESSESEESERSEESEEESSESSSSSESESSESSESEESEESEEESSSSSSRSEERESSESSRESESESSSSESEESEEESSEEESSSESEERSSSSSSESSSSSSSSEESSESRSSSSESSSSEREESEESSESSSSSSEEEESSSERESSSSESEEESESEESSERESEES
SSRRSSSSESSEESSSSSSSRSSSEESEESSSESESSSEESSEESSSSRSEEERSESSESSRRSSRERSSESERSSSESEEESEESRESSSSSSSEEERSSRSESESSSEESERRESESEEERRRESREERESSSSSSSRSESSSEESSERSSEESESEEESSESEEESSSSEESESEEEESSSSSSRESSSSSSSSESSSRSESSSSSESSSSSSSSEESRRSSSEESEEESESSSEESESSSSESEEERSRERRSSSSESSSEEESSEREESSSSESEESERRSESSEESESSERSSSEERSEESEEESSRSSSREESREREEEESESSESSSSSSSSSSSEEEERSSSESSSSESRSSSSSRSEEESSESSSSERERSESSRSRESERESSESSSSS
ERRSSEEESESSSESESRSESEERERSSSSSSSSEEESRSSSREESSSEEEESESERESSEESSSRESESSEERSSSESEESSSEESESSSSSSSSEEEEESEEESEEESRSSSSESSSSEERESSESEEEESSESSSEEEREERSSSSSSEEEESEESSESSESSESESSSSSEESRESSSSSEEESSSRESSSSESESESESRSESSSRESEESSRSSEESSSEEEERSSESREEESSSESESEEESSESRSSEESESSESSESERSSESEESSEESSSEEREEESSSSESSREESRRSERSRSSESSSSSEEESSESSRRSSSSSRSSESESESSSESSESSEESSSSSRSSSRSREEESSSEEESRESSSRSESEESSSEESSRSSESEESSSEEE
ERESSSSSEESESRSEERSESEEEESSEESESRSSRSRESESERESEESEESSSSRSSRSSSESESEESESSSSEESSSSRSEESRSRSRSESSERSSSESEERESSESERSSSESEEESSSESSRERSREERSESSEEERESSSSESSSSESEEEESEESSSSSESEESSESSRSSSSSREESESRESERSSSSEESSSESSSSEEESESSSRSEERSEEESSEESSESSSSSSESSRESSRSESESSSSESSESSSESSSSESEESSESESRSSRSESSEEESSSESRESEEESSSSRESSSSSSSSSESSSRSSSSERSSSESSESSSSESSSSSSEESSSSEESSEESSRESSSESSSSRSSSSEESSSSSSESEREEESSSEESSSSEESSRRES
RSSESSEESSSEESSRESESESSESSSSSSEEESERSSSESEESSSSSSSSSSESRESSSESSSEERESSSEESSSESESSSSSSEESSSEEEESSSSERSSSESSESRSESRSSSRESEEESESERSSESSSEESSERSSESSRESEESEESSSESRSSSSRESEEESSEESSSSESSSEESESRSREEEEEESSEEEESRSERESESSSSSSSESSEESSESSSRSESESSSSESESSESSSSESESSSEESSEESSSSSSSSSESEEESSSEESSRERSEESSRSSSSSERSEESERSSESSESEESSSESRSESSSESSSSESSEESRESSEESEESSSESSSESSESEESSEESSSSESSRSSSESESESSESSSSSEESRESESEEREESSSSE
