                                                                                                                                                                        ***    *|*   *|******|*  ***               *|*    ***             *|*                        ****                           *|*        *|*                                                                *****                         
                                                                                                                                         ***                            *|*    *|* ***|**|*|*|*  *|*   ***         *|*    *|*             *|*                        *||*                           *|* ***    *|*    ***                                                         *|*|*                         
                                                                                                                                         *|*                            *|*    *|* *|*|**|*|*|*  *|*   *|****      *|*    *|*             *|*                        *||*           ***             *|* *|***  *|*    *|*                                                       ***|*|*                         
                                                                                                                                         *|*                            *|*    *|* *|*|**|*|*|*  *|*   *|**|*      *|*    *|*             *|*                        *||*   ***     *|*             *|* *|*|*  *|*    *|*                                                       *|*|*|*                         
                                                                                                                                          |                             *|*    *|* *|*| *|*|*|*   |     | *|*       |      |               |                         *||    *|*     *|*              |  *|*|*  *|*    *|*                                                       *|*|*|*                         
                                                                                                                                          |                             *|*     |  *|*|  | | |    |     | *|*       |      |               |                          ||    *|*      |               |  *|*|    |      |                                                         |*|*|*                         
                                                                                                                               -   -   - --        ---   -        -    --|      |   | -  |-| |  - -- -  ---| -     --  -   --  ----   --   -     -            -  - -- |-    -|    -- |     -- -  --  -   |-|--  |  - --|  -- ---     - --  ---      -  -        --  - -   -      |-| |   -  -    ----- - ----- -
                                                                ***                                                          --S-- E- -S-SE  ---  -SSS- -E-- -----E----SS|-- ----- -| S---E- - -R-ES-E--EEE|-E-    EE--S-- ES--SSRS-- ES-- E--- -E- - --------E--E-EE--E   -S|- --ES ----- EE-S--SE--S --|S-ER  - -E RE- -EE EEE-  - S-SS- SES--  --S--E--- ----EE--E-E  -S-  ----S| |-- R- E--- ESSER S-EEEER-S
                                                                *|****            ***          ***               ***         EEEES-SE-SEEEE--SSE--SEESE-RESE-EEEESEEEEESS-EE-SEEEE-R--ESEEES-E-ESSESEESSESE-RRE----REESESS-EESEEEEESS-EEEE-SSSE-EEE-E-SEESSESSESESEEEEEE---ES-S-SSRE-REEEE-ESSSERSESSS-SE-SESE--E-ES-SSE-EEE-SSEE--S-EEESS-EESEE--EEEEEEEES-EESERSSSSSE--EEE--SEEEE---ES-SS-EEEE-ESSEE-SESSEESSE
                                                          ***   *|**|*            *|*          *|*          ***  *|*        -SSEESEEREEEESEESEESESEESEESEEEESSSEESEESESESEESEEESESEEEESSEESERESEERSEEESESSEEEEESEEEERSEESSEESSESEESSESESSEEESEEEEEESSESSSEESEEERSRESESEEESSESRSSSESSSSESSESSEESESSESESSESEEESSEEEEESSESSSEEEEEREESEEEEEESEESSSSSERSSEEEEEEESSSEESESEEEESSSSSESEESEESSSEEESERSSESSESSEESSSSSRESSS
       ***                                                *|*    | *|*            *|*          *|*          *|*  *|*      --SEESSEEEESEEESEEEREEEEESSSSSREESEEEEEESEESESESSEESEEEEESSSSESRSSSEERSERSESEESEERESSESESSSEESSESSSESESEEESESSESEEEEEEESESEESSESEESESSEEEEEEEESSRESRESEEEEEEEEEEESSSERRESEESSRSESEEESEESEESESESSEEESRSEEEEESSEEEEESSEESSESESSRESSEESESEEESESRRREESSEESESSEESEESRSREESSESSESESSEESSSSSE
       *|*                          ***                   *|*    |  |              |            |           *|*  *|*    --SEERSEEESEEEESSESSEEESSSEESRSESEESSSEEEESESEEEESEEESESRRSSRESSSSEEEEEEEEEEEEEESSERESSEESEEESEESSESEREESEEREESEEESEESESSEREEEEERSSSEEEESSSEEEESEESEERESEESESSEESSEREEEESSSEESESEESSEEESSESESSESESSEEESEEESESEERERESEERRESSEEESEESSEESSEEESEESEEEEESESSESSSEEESEREEEESSSESSSEEEEERSEEEER
       *|*                          *|*                    |  - --  | -            |           -|  --        |    |   --EEESEESEEEEESRSSSSSSSESSESSEEEEESESESEESESEEESRSESSSSESESEEEREESERRESESSSRRREESEEESSSEEESSSESSSSESEEESSSSSEEESEEERSSEESSEEEEEESESESSEEEEEEESSESSESESSSEESSEESSSSESESSESESSSERESESSESERSESSEREESREEEEESESSEEEEESESEESERSESSEESSSEEESREEESESEEESSSEESSSESSESEESESEEESSESSEESSSEEESEEEEESEE
       *|**                         *|*                   -| -E-SE- --R--        --- -       --E---SR-       |    | --SEESESREESESESRSEESESESSESEESEEEEEEESEEESEESSEEEEESSSERSEESSSERESREESEEEEESSEESEREERSSSEESSEESSESESSSSESEEEREEEEESEEESESEERSSEESESSSEESEESEEEEEESEEEEEEESEEEEESEEEEESEESSESRSESSESEERERSEESEEESESSERESSEEESESSESEESEESESSEERSESSERESEEEEEEESSSSEEESSEREEESRESEEEEESESEEEEEERESEREEEESSESSS
       *||*       ***               *|*                  -S--SSESRE-SSERS- ---  -EES-E-------SSESEEEES--------    --ESSESESSSSSSEERESEEEESSSEEESESSREEEEESEERSESESESEESERSEEESESEEESEEEEEEESEEEESSSESSEESEEESSESEEEESSEESESESEEESEEERESRSESSEEESSSESRSREEEESSEEESEREESSESSEESSEESSERSEEEEEEEEEEEESEERERSEESEEESEESEESESEEESSEEEESEREEESSSESSESSSESESESESEESSESSSESSEESESEEEEEEEEEESESSEEESEESSESEEEEESSSSERESSER
       *||*       *|*               *|*   -- --         -EESEEEREESEEESESE-SRS--SSEEEESSEEEESESSESEEEESESEESSE----EEEEEEEREERSEREESSSEREEESESSSSSESSERSSESSSESSSESSSSSSEEEEEEEESEEESSSESEREEESERSEEEEESSSSEESEEEEESSERSEEESERSSESESESEESESESEEEEESSERSSESSSEEERSSESESREREESSEEEESESSSSEEEEEESEREEERERRESREERESSSSSSEEESESSEESSEEEEESEEEEESSEEESESEEEEESRSEEESEEEEESEEESEEESSEESSSEEEERESESEERESESSESEEEEEESEESEE
        ||*       *|*               *|*  -SE-ER---     -ESESEEESRSESSESEEEESESEEEESEESSESSSEEEESSEEEESEEEESSSEEEESSSEESSEESSESSSREEEESESSESESEREEESSSEESSSSESEEEESEEEEEESEEERSRESESESSSEESEESESSESSEESSESEESESSSSESEREESEESESESESEEEESSSSEEESSSSSEESEEEEEEESSSEEREEEEEEESSSSSSEEEESESSEEESEEEESESESSEESSSEEEEEEESEESSSESEERESRESEESESSESEESEREEESRESSEEESEESEEEESEESSSEEEESSEEEEESSSREESSESRSEEEEEEESEEESSESSEES
        ||     -  *|*                |  -SEESSEESS-  --ESSERESSSSESSEEEEEEEEEEESEESSEEESSSEEEEESESSSSSESEESESSERRSSERESSEEESERSESSEEESSSESESSEEESESEESSSEEEEESSSEEEEESEEEEESESSEEERSEEEEEEEESSEESESEEEEESEESESSESEEEESEESEEEESSSSEEEEEESEESSEEESESESSSEESEEEESEESESSESSEREESESEEEEEEERERESSEEESEESESSSREEESRSEERSEESSSEESERSSEESSESSEESESSESESSESSEESEEEEEEESESEEEEESESSESSSSSSEESSEESESSSSSESSESEEEEEESSSESESSS
        -|- ---S-- |                 |--SEESEEEEEEE--ESSSESSESEESEESSEESSEEEEREESEEEEESESEEEEEESEESSSSESSEEEEESESSEESEERSEESESSSSEESSESSEEEESSSEESEEERRESSEEESSSSRSEESSREEESSEEEEEESSSSERSESSEESSESEESSSEEESEEEESESEEREEESESSESSSSEEESESEESESEERSSEEEEEEREEEESESESESEEEEESSSEREESSSSESSSEESESSERSEEESEREESSSESEEEEEESSSSSEESSEEREEEEEEESSSSESEEESESSSEESEESERSEESSSESEESSRSESESESSSSERESSSEEEESSESSSSSSESESEESEE
--------S-R-EESESE-| -    -         --EEEESSSSEEEEEEEEEEESESSSESSSSEEEREEEESESSEESESSSSSEESEEESESEESEEESEESESEEEEESSESSEESSSEESSSSEEEEEESSSREESEESEESREEEERSESEEESREESSESEEESSEERESESSEEEEEESSEESEESSSSESESSSESSESEERERSSSESSESEEEESESESSESEESSSSSSESEESSSSESEEREEESEESRSSSEEERESSESEEEERERESEESEESRSESEESEESSSSESRSEESEESEEEEESSSESEEERESEEEREEESSERSEESESESEEESEEEESSEESSSEEESESESESSSREESSEESESREEESESEEEESSS
ESSEEESEEESSSSSRESE--E-  -S--- -  --EESSSREESESESSESESESESESSSSEESSESSREESEEEESSSRSEEEESSEEEESSSSRSERSEEEEEESEESEEESESSRSSESEESESSSEEEESSSSERRSRSSSESSSESREESESESESSEESSSSESESSEESSESEEESSSSSEESSSESSEEEESEEESEESESSEEESEEEESEEEESSEESSRSSESESESSEESEESEEEESSESERREESSSSSEEESESSEEESSEREEEEESEEESSSEERESESRESSEEEEERSESEESEEEESRSESEEEEEEESSEEERSESESSEESSEEESSEESSEEESRSSEEEEESEEREESSSESEESESESEESESSEESEESSSS
ESESSEEESESSEESSSESEEES--SESSS-E--EESSSSESESSEESSESESSESEESSEEESSSSSEEESSESEESEEESSEESSSSEESSSESRSEEESSSSSEESSSSEEEESEEEEESEEEESEEEESEERESSSEESESSSESREEEEESSEESSESSEESSSESSRRSSEEEEESSSESEESSSESESRESEESSESSSEEEESESSSESSSESEEESSESEESERSEESSEEEEERSSEEEEEESRSESEESEERSRSSESEEEEESESSESSSSSEEEESSSESEREEESSSSSESESSSSESESSSRSRSSSEEESSSSSESSSESESEESSSESRSSSESSEEEESSESRREESEEESSEEESSEESSSESEESEESSERSSSSSSSSS
SERESSESEESSEESESSESEERSESEESESSEEESESSEEEEEEEEEEEEESSSEESSSSSSSESSREESSEEESSEESSSSEEESESEEEESSREESESESESEESRESSSSSERESSESESEEEESSSESSSESSESEEEESESEESERESESESERRSESEEERSSEEEEEEESESERSSSEEESSEEESESSSSESSSEEEREEERSSEEEEEERSSRSSESESSEEEEESEESSSESEEESSEESEESEESRESSSSSESSSSRSRSEEESSSSERSEEERRSSESSSRSEESRSSRERSESEEESSEESESEEEESSESEESEEESESEEEEEEEESRESSERSSESSREESSESESEEESRRSEESSERSSESSSSSSSSESSEESESEEEE
ERESSEEESEESREESSRESEEEEEEESSSSESESESERSEESSSRESEEESEESEESSREEEERSEESEEEESESESSESRSSESESEEESSSEEEESESEESSSSSEEEESEESESEESSEEEESESESESESSSSEEEREEESEESSSSSESESSSESERESSESSRESRESESERSSRSSEESSSESERRSEESSEESSSRESESEERSRSEEREESEEEESSEESSESEEESSSSEESEEREESESESEEESSEEESEEESSSEESESSRSSSEESESSSRSEEESEEESSEEESSSSSEEEEREESEEESESERSSESEREEEEEEEESSSSEEESSSSSSESEESSRSESEEEESESEESESEEEERREEEESEREEESESEESSSEERSERE
ESSESSEEEESSESERSESSEEESSSSSRSEESSSSRSSSEEESEEESERSSEESEEESEESSSRRESSSESESERSSSEEESEESEEESSESSSEEEEEEEESSEEEEEEESESSSSSSSSSESSESESSSSERSESSEREEEESSSSESSESSEESESEESSEEEEEESEEEEEESSSESERSSSEESSESEEEEESERERSSSEEEEESESRESRRSSESSSEEESSSSEESSESSEESRSSSESSEESSESEEEEERSEESESEESSEESEEESEEESEESEEESESSSSESEEEESEERSEESRESEEERSERSSSESESESSESRSRSSSSSESEESSESESESSESEEESESREREEEESESSSSSSEEEEEESEESESSSEESEEEESESSS
SESSRSSEESEESSEEESSESSSESSEEEEEEESSRSSSEEERSESRSSSSEESESEEEEESEESSSEEEEESSRSESESRSESEEEEEEESSESSSSESEEEESEEESREEESSSESEESSSEEEEEESEEESEESSERSRSSESEEEEESSESSESEEEERSEEREESESRSSESSSEESEESESSSEESSEESSEEESSRSESRSESSERSESSSEESSESEESSSSSEEEEEESESEREEEREEEEESESESESSSSSEESSSEESSSERSSEERSSSEERSESEESEEEESSSSSSESESSESEERSERESEESEESSESSEESSSEESSEESESEESESSEEESSEEEESRSSRESSSESSSSEEEEESEESESESESEESERESESEEEESSE
SSESESRESSSSSESSEESSSESSESSEEEEESESSESEESERSESSESRSRSEESESEEEEEESEEERSEESESSREESESEESESSSSSESERESSESSSEESESESEEESEESSSSSEEEESSEERESESSSESESESSEESRSSSSSEESSESEEEESSSESSSSSSSSSESSSSEEEESSSESSSESESSSEESSEESSEEEESSSSRRRSESREEREEEESESESESEEESSEESSSESSEEEEEESEESEESEREESESSEEESSESRSSSERSEEEESSSEEESEEREEESRSERSSEEESESSRESSESSRESEEEEESESSSSEEEEERSSSSSSSSEEEESSSSESEESEEESESESEEEEESESSSESSSSEESEEESEEERSSSSSS
SESSSSSEEESSEESSEESESSSEESEESSSESEEESSEEESSEESEESEEEESSSEESSSSSSSSSSRREEEEESESSERESESEESSSEESSSSSSESSSRSERSSRSESSREERSSEESRESESSSSESEREESSEEEEEEEERESESSREEESSEESESSSEEEESSSSSSSEEEREESSEEESSEEREESEESEESSRSRSESEEEESSSEESESESSESEEESSEEESEESRRSSEESSREEESREERESEEEESEEEESSESSSSESRERSESSEEEEEESEEESSEREEEEESSSEESESRRSSSEEEESSESESERSESSSESRSESESESSSEEESEEEEEEESSSSESSSSSSRSSEEESESSESSESSSSESEESSESSSESSEESSS
EEESEEESSSSSEESEEEEEESSRSSEEEEEESSESSSEESESSEESRSEEESSEEEEEESESEESEEESSESESESRRESSSEESSESESSSRSSEESEEESERSESESESEESEEERESSSESSESSSSERESESSSEERSEEESEEEESSSSSRSSSESESESSEEESRESSESEERESESSRSSSESEESEESESRRSSRESESESESSSSSEEESSSESSESESSEEESRSEEESSSSSSSEEEREESSSRSEESESESEESSERSESSRREEESEEREEERSESESERSSESSESSESEESSSSSEEEEESSSSEEERSSSEEEESSESRSSSSSEEESSEESREEESEESSSEEERESEESSESSSEREESSSSEESSSREEESSSSEEESES
EERSESRSSSESEEEEEEESEESEESSEESSSREESEEESSSEESSEEESESESESEEEESSEESESSEESESSSSEESESRSSRSESEEEEERSSSESSSSEEEERERESSRSSSSESESESESSSESEESESESSSEEESEESSSSRRERESERSSSSESERSREESEESESSRSESESEEESRSRESSESSEESSEEESSSSESSSESSSSSSEEEESSSESEEEESSSSSSREEEEEEEEESEEEERESEESEESSSSESESESEESESEERSSSSESEESESSSRESSEEEEESSESEESESEESSSEEESSSSESSSSSSEEESRESESEREEESSESSSSEEEEEESSSSEESEEESSSSSSESESSSSEESSSEESRRRSEEESSSESEEES
SSSRSEESSESEESEESSSEERSSSESSEESESEESEEEESRSSEEEESSEESSSSSSESSSSSSESESESSESSESESSRRSSEREEESSSESSESREEESSSSRSSSSESSSSESESSSSRERSERERSESSSEEEEEESEESESSSEEESREESRRSSEESSEEEESSESSSSEEEEEREEESESSESEESESSESERESESESEEESSSESEESEESEESRSRESSESSSSSESESSSSRRRSSESESESSSSSSESESESSSSSSESSESEEREREESEEESEEESSRSSEEESESEEEESSEEEESSESSSSEESEERSSESSRSEESESSSSESESEESRSSSEEESESERERSSERSEESSSESSERSSSEESESESSEESSSESRSSSSSE
EEEREEEESEESEESESEEESESSESSRERSESEEEEESESESSSRESSEESESSSSSEEESESEREESSSREERSEERESSEESESESSSSSSESESEESSRRSSRSSESSEEESSESSEEESSRSSEESESSESESSSESSSEESSERSESSSSSESSSRSSESSSSSSESSESESSESESSSSSSEESESSRSSESSSERESSESRESSEESEESEESESSSSESEESSREESSSSSERSSESEEESEEEEEEEESEEESERESSSSESERSESSSSESSESSSESESSESSEEEESESESESSESSRSSRRRREESSSSESSSSRESSESSSSSSSSEESSSSSSRESSEESEEESSSESSESESSERSSREEEEEESESESRESSSSESSESRES
SSSSESSSREESERSSSESSEESSESEEEERSESSESESESSSEEESESSSREEEEESESEEESSSESSSSSSSESEESSESEESEESESSSSSSEESESEESEESSSEESESEESESESSEESEEESSSSSRSEEEERSSRSESSSEESEEERESESESSESESESSEESSSSSERSSSSEESESESESSESSEERESESSESSSRESSSSEEEEEESSEEEESERSESSEEESSESEESEEESSESESESEESSESERSSSSEESSSSSSSSSESESSEEEESSSESSEEEESESSESSSSSESSEEESSSRSEEEESESESESSSSSESSSEEESSSEESSSSSSEESESRSESESESSEESESSRSSSSESSESERESEESEEESSESSSESEESS
ESERSEESSSEESSSSSSSSEEESESSEESESSSEEESSERSESESSEESESSSRESSSEEEESSESSSEESESSSSRSESSSESSSSRSEESSSSSSSSSEEESEESSESSSEESEEEESSESEEESRSSSEEESEESSESEESESSSSSSSEESSESSSSSSSSRSERSSSRSEEESSEEESSEERSSESESRESSSSEEESESSSESESRSEREESRSESSEESESSEEESRSSSEREESSEERSRSSSRSSSSSEESSSESSREEEEERSRSEEESERSESSESRSSSSSESSEESESESRESSSSSSSEEEERSSESEEEESEERESSRSESEEESRSSSESSESSSESSSSSSSSSESSSSESSREESEEESSEESRESSSSSSESEEESSESE
ESEEESSEEEEESSSRESSSSESSSEERESSEESSRSSESEESREEEESSSESSSESSSSSEESERSSSEESESSEERRSSRESSEEESEESSESSEEESEEEEEEESSSEEESSSRSESEESRESSESSSESESEEESESSESESEEESEEEEEESESEESSEESSESSEESEEEESEESESSSESESRESSESSSSSESSSSSSSSESSRESEEEESSSSESEESERSESRSESSSSSESERRSSESESSEESSESSEEESEREEEEESSESESSSSSSESSESSSSSEESRESSSRESEEESRSESSSEESSSESSSSRSSSSEESERESSRESESESESEEEESSEESRSESSESSSESSSSSEESEESSSRESSREESESEEEESEESRESREES
ESESSSSESERSSEESSRESESEESSSSSEESEESESRESSEEESSSSSSSSSSSSESSSEEESESEEEESEEREESESERSEESESEEESSESSEESESSEEEESESSEEEEESESESSESSESESSSESRSSSSSSESEEESRSSESRESESSSSSSSSSESSRESEESSESESSSSRESSESESREERSSSSESERSSESSSEEEEERSEERSSSSSEESESEESESEESSERRESEEEERSSSEESSEEEESEESRSSEESSRSSSESSEERSSRSEESSSESSSESESSESSSSESSERSSSEESSESRESRRRSESSSSSSSSSSSSEESSRESSSSSESSEESSEESSSERESSRESSSESSSERESESSESSSEESRRSSEESSREESESES
RESSSSEESSSESSSSESESEESSERRESESSSSESSEEEESESSSSSEESSSEERSESSSSEEESSSEESESSSSESSSESEEESSSSSEEESESSSEEESESESSSEESSSSESSSESSSSERSEEEESESESESESSSEEESSRSEEESSSESSERESEEEEESSESESSESSSESEESRESESRSESSSSESSSSSEESESSESESESSSEEESESEEEERSSSSEERSEESSEEESRSESRSSSSSSEEESSSSSESEEESSSSSESSSSESSSEEESESSSSSSSRRSESEESSSSSSESSEEESESSSESSSSESSRSERESEEESSESERSEESSSREERERRESESEESRSEESSERSSESSEESSSSSESSESSSSSSSERSSRRRSEER
SSSEESEERSSESERSESSSEESSSESEESESEEESREESESSSSEESEERSSSSSEEERESSSESSSSSSRSESSSSSSESSRESSSERESESSSSRESRSSSEESSEESESESSEERSEESSSESSSSSSESSESSSESRESRESESSSESSESEEERERSREERSEEESSESSSEESESSSEEESRSREREESEESSSSESRSSESSSEESESSSRESSESSSSEERESSESSESSSEEESESSRESSESSSEESSEESESSESEESESEEESERSSSESSESRSSESSEERSESSESSEESEEESSESSESSEESSESSSSSEEESSSEEEEEREEEESSESESERRSSESSSESSSSSSEESSERESESEEEEEEESSSESESRSSEESEEESES
ESSSSERSESEESRSSSSSSSESSEEESSSSSSSSEESSSESSRSSSSEESRESEESSSSSSEEERSSEESEESEREEEESESSERSEEEERSSSSEEESSESESSESSSESEESESERSSSSSSSSSSSSSEEESSSRSSESSSSRESRSSSESSSSESSSSESSSSSESRSRESEEESSSESSEESEESSESESESSSESSSSSSESESSESSESRSSESESESESEESSEESSSESESSSSSRSESESSSSESSSSSSSESEESEERREESEESESEEESESESESEESSRESSESSESESSSSSERSSSESESSSSSESESSESSRESRESESSEESSSSEESESESSESEESSEEERSSSESESSSERSESRESERESESESSEESSSSSSESSS
SSEEERREESREERESESSSERESRESSSSSSSSSSSEESERSEESSSSSESEREERSSESSSESSSSSSERESSSSEESRERSRSRSSSERSSESSESSSSEEEESESSRSSSESSSERSESESEESSEESRSSSESSSRSSSSSSEESSSSSESESSSESSESSRSSSSSEESSSESSESSEESSESEEESSRSESSSESEESSRSEESSEESERSSSSSSESSSRSESSRREEESSSSSEEESSSSSSSSESESESSSEEEREERESSSSSESEERESSSESSSSESSESSEESSSSEEESEEESSSESEESSSSSSSSEERESESSSSESSSSSSSSSSSSREEESEESSSSESSEESSSSRESEESSESESSSEEEESESESSSSSSSEESSESS
SESSESSEEEESREESESSRESEESSESSRESESRSSEESSSESSSRSEEESEESSSSESSSRRSSESEESRSESESSESRESSSSRSSEESEEESRSSRSSSSESSSSSESSSSESSEESERSRSESSRSSRSSESSSSEESEEEESSSSERERESESSSESEERRESERRRERSSSESSSRSEEESSSSESESESSSSESSSSREERSESSESESSSESSSRSSSEEEESSSSSSSSSESSEEESSEESESSSREESSEESSESSSSSSSEEESEESEEESSEEESESEESSEESSESSSSESESSSERSESSRESSSSESESEERSSSESEESRSSSESESSEEESSESSSESSERESSSRSSEESESSESSERSSSEESEESERRRSSSESSRSES
