                                                     *|*  *|*                                *|*            ***                             *|*         ***  **|*   *|*                ***                                       *|*                                   *|*  ***              ***         ****|**                                        *|***|*           *|**|*              *|*               
                                                     *|*  *|*                  ***   ***     *|*            *|*              ***            *|*         *|*  *||*   *|*   ***          *|*                                       *|*                                   *|*  *|*              *|****      *|**||*                                        *|*|*|*           *|**|*              *|*               
                                                     *|****|*   ***            *|*   *|*     *|*            *|*              *|*            *|*         *|*  *||*   *|*   *|*          *|*                                       *|*                                   *|*  *|*              *|**|*      *|**||*                                        *|*|*|*           *|**|*              *|*               
                                                     *|*|**|*   *|*            *|*   *|*     *|*            *|*              *|*            *|*         *|*  *||*   *|*   *|*          *|*                                       *|*                                   *|*  *|*              *|**|*      *|**||*                                        *|*|*|*         ***|**|*              *|*               
                                                      |*|* |    *|*            *|*   *|*     *|*            *|*              *|*             |          *|*  *||*   *|*   *|*          *|*                                        |                                     |   *|*              *|**|*       |  ||                                          |*|*|          *|*|  |               *|*               
                                          ***         |*|* |     |             *|*   *|*      |             *|*              *|*             |          *|*  *||     |    *|*          *|*                                        |                                     |    |               *|* |        |  ||                                          | | |          *|*|  |                |                
                                   ***    *|*       - - |---   - |  - - - - - --|  -  |-      |-- --   -  -  |-  --  -   -- - | -  - - -- -  -   --   -- | - -||---  |-  - |- - -     - | -        --           -- -       ---    -   - -   -  -  -    -   -- --      ---    |           - - -|  |--    - -- -- -  -            -  - -     -   --- --  --- | ----   - ---| - ---   ---        -|-  -  --      - 
                                   *|*    *|*       E-S-|SEE---E - -E-E-E-S-E-SS| -S- |E--   --SS EE---S -E- |S- ES- E---ES-S-| S--E-E-ES-S--E --SR - ER-|-E E|-EEE --S--E-|S-R-E-- --E-| E-  - -  SE-----  -- -EE-E-- - - EES- - E---S-S- -R -E  S-   E- -EE-EE-- ---SSS----- -- - -----S-S E| --ES--- E-SE-EE-E- R ----  --- -E- R R-----E- -SEE-EE--EES-- RESE --E-ESE| S-SRR- -EES- -     S-E  S -EE------S-
        ***                        *|*    *|*       ESRE-SEESSEE-E-EEEEEEEESSEEE--ESE--SSE---EEEE-EEEEEE-ESE--EE-EEE-EEREEREES--SEESEESEEESSES-EESE-S-SEE-EE-E-SREE-EESSESE-EEESEES-EEES--ES--S-S--ESESSSS--SE-EESEEES-S-E-EESS-S-ESSREEEE-EE-ES--ES---SE-ESEESSSS-SEESSSSSSSE-RE-S-ESSRESSE-S--SRRSSEE-SSSREESSSE-S-RSEE--SSS-ESS-E-SEESEESE-ESEESEEEEEESEE-EESS-EEEEERE--EEEEEE-ESESS-E-----SES--S-RSSEEEEEESS
        *|**                   *** *|*    *|*      -SSEESREEREESSESSSSSESSESESSSSEREEEEESEEERRESSSSSERSSESEESESSESSSEESESSSEEESSEEREESESEESESESESESSSEEESEEEESSSSESSSEEEEEEESEEEEEESEEEESESESEESSESSSSEESSEEEEREESEEEEEEEEESSESESEESSESEEESSEEESRSEESEEEESSEEESESEEESSEESESSESSSESSEEEEEEERSESRSESSEEEEESEESEEREESSSEESEESEEESESESSEESESSESEESSESEEESEESREEEEERSRESSEEESEEESEEEEESSSSEESSEESEESSEESEESSESRSEERSE
        *||*                   *|*  |     *|* -  --SEEEESEEEEESESERESESESEESEEESEESSSEESERSESRESEEEEEESSEESEEEEESEESSESRSSESESESEEEESSEEESESSESEEEEEREESEESSSSEREEESERESSSEESESESSESSSSEESESEESEEEESSESEESSSSSSSEEEEEEEEEEEESSESSSESSSEESEEEESEEEESEEEESSEEEEESSEESESESEEEERESSEEEESEESESEEEEEERSEEEERSRESSEEESEESREREEESRSSSSSESEESEEESSEEEEEESSEEEEEESEEESESSEEEEESEEESSSEEEEEESEESESEEEESEREEEESEEEESSSESESSE
        *||*                   *|*  |      | -S--SSSESSSSEEERESESEEEREEEEEESSESEESSREEERSSEEEESSESSESSSESSSSSSSESESEEEESSEEEEEEREEEEERSREREEESSEEEESSEESERESSSEREESEEEEEEEEEEESSESSESSSRSESEESEEEEEEEEEEESEEEESSSSSESESSSEESEEESERRSSERESESESEESSESSSEESESSEEESSRSESSEESEEEEESESSESEESSSSESSEEEREEEESESSERSSSRSSESEEEEEEEESEEEESSEESESEESEEEERSEEESSESEEEEEEEEEEEESERERSESSSESESEEERESEESEEEEEESSSSSSSSEEESEERER
        *||*                    |   -      |-SSSSSESSSEEESESSRSSEEESSRESESSEESSEESESEEESESEESSESSESESEEEEERSESSEESSEEESSEESEEESSEEEESEEEESEREERSSESEREEEESESESSEEERSRSSEEEEEEESRSEEEEEEEEESESEEEEEESEEESSEEEEEEEEEEESESSEEEESSRESEEESEEESEEESESREESESESEERSEESEEEEEESESSSSSESEEEEESESRESSESSEESSESESSESESESSESEEESEEERSSESEEEESSSEESESSEEESESSSESESSSEEEESSEEESEEEERSSEESESEESEREESEESESESRSSSEEESSESSESEESSSEEE
        *||*                   -| --E---   -SSEESREESSSRESSSESSERRESSERSRESSESSSEREEEEEEEEEESEEEESSEESSESEEESREESEEEESEEESESEEESSSEEEESSSESSEEESEESESEESSSEEEESESREEESRSSSRSEEEEESSEEESSSERRREEESSESRSEESEEESESESRSSEESEEEEEEEESESESSSEEEEESEESEESSEEEEEEEESEEESESEESRSEEEEREEESEEERESESESESSEESSSEESSSSESEEEEESSEEEEEESRSSESEEEEEESESSSEEEEEEERESSEEREEESSSSEEEESESESRESERSEEEEESRSEEEEEESSEEESESESSERSSEEEEESS
         ||            -     --E--SSESES---ESSSEEEESSEEESEESESEESERSESESSEESEEEESESSSSSSSESSSRSESREEEEESESSERSESREEESESEERSSSSEEEESSSEESSSERSEESSSSEESSESEEEEESEEEEESEEEEEEEESEEREESSESSEEESSEESESEEREEESEEESESSSESSSSESRESESSSESEESESSEERSESEEESEEEESSESEESSEEESEEEESEEESESSESESESEESSSSSSSEEESSSSSEESEEESEESSSSSESREESEERSRRESSEEESESSSSESEESEESERESEEEESESESESSEEEEEERESSEESSEREEEESEEESSSSESSESSESSERRESSSEE
         ||    ---- ---E- ---ESSSSSSEESEESEEEESEESEEEEEEESSRSSSSSSSEEEEESEESSESEEEEEESSESRESEESEEESSESESEEEEEEESERSSSSESESSSSESSRSEESEEEEESESESSSSRSESSESEESESEESEEESEEREEEESEEEESSEEESEESSRESSSSSSESSSSSSEEEEEEEESEESSEESESESSEESESSEEESSSSEESSEREERRESSSSEEESSESEESSESESEEESESEESESESEESEEERSESSESEESSSSEEREEESESSSEEEESSSSESEREEEESSESEESSEESSEEEESEEEESEESESSSEESSESRESSRSSSSEEESEESESESSEESRRESEESEEEESESSS
     --- ------RERE-SSESS-SEESESEREESEEEESSSSSREEESEESEEEERESSSESSESERSSESSSEESREEEESESSEEERSESESESSSEEEEEESSESESEESSRSEESESESSSEEESSESRRESERESSSEERESSSEREESSSEESSSSEEESSEESRESSEEEEEESESESEESEESEEEESEEESSSSSESSESSSESEEESSESSEEEREESSESEERSESSSSSSSSRESSSSEEESSEESESSESEREESSEESEESSEEEESESESESSEERSESSREEESEEERSEEEEESESEEESEESEESESESEEESEEEEEEEESEESESSEEEEESSSSESSSSSEREEEEEESSRSRSSRSEESSSSESSSESEESEEES
    -ESE-RSSESEEEESESEEEEERESREEESSEEEERSRSREERSEESSESEERSEESSSRSESEESSESSSEEEEESESERSEEESSSEEREESRERSSESSSESSESEESEEERSSSSSESSSSEESSSEESEESSEESSEESSSEEEESSSSSRESSSESSESEESESESEEEEEERSSSESEESSEESSESESESSEESSEEESSSSSSEEEREESSSSSEESEESERESREEEEEEREEEESSEEESEESEESSEESSEESSESRSESEEEEEESSEESSSSSRSEESSSESSERSSSESSESESSSSSSEEEEEEESSSESSSSESSEEERSEEEEEESSSSSEEESSERESSSEEESEEEESSEEESEESEEEREEESEESESSSSESSE
 ---EEERESEREEEESSEESSSESESSEESESERESESSSSRSEESSSESESSSEEEEEESRSREESSEEESSEEESEEEESREESSSSESSSESSEESSESSEESSSESSEESSERESSSEEESESEESSSSEEESEREEEEEERESEEEESSERSSSESEEEESESEEEEEEEEESEEESSSEEEESSSEESSEEREEEEERSEEEESRESEESESEEESSSEEEESESESREESSESSEEEESESEESEESSSEESSESSEEEESESEESSSSSESSEESSSEESESESERESSSSSEESSESEESEESESSSEESEEESRSESSERSEEESEEEEESSEESESESREESSSSSRSSSEEREEEESSESEEESSSRSESSSEERSSREESESESSE
-SESESEESSSSRSSEESRSEEEESESESEEEESESRSEERSESSEEESESSSSESSSSEESSEEEESESSSESSSSSESSSSESESSREESSEEEESRSEEEEEEEEEESESESESSSEEESEERRERRESEERSESESSESESSESESRESSSESSESSSSEESSEEESSEESEESEESEESSESSSEESSEESSSSSSESSEEESEESRSESEESEESSESESSSEEEESEEEESESSESRSSSSSSESSEEESEEESSEESEEEEERSESSRSESSESSSSSSESEESEEEEEESSSSESSSEEESRESEESEERSEEEESSREESEERSREEEESSEEESSSERSSESEEESESESSSESESEEEESEESSEEESESSEEESEEEESEEERESSS
ESSSRSSRSESESESESEESESEESESSEERESESSSRSSSESSESESEESSSREESEEESRESSSEESESEESESESESESESSRESESEESRSESSSRESEREEESEESESEEEEESESEESRESESEESSRSSEESESEESSESEERSSEEESSSEEESESSSESSSSESSEESERRESESSSESSESESRSSSSESSESSEESESSSEREESREESSESSSSSESESESESSSEESEEESEEESSEEEESEEESESEESEEEESSEESEESEESESSSSEEESESSEREESESSSSESESSEEESRESSSESESEESSSSSEEEEEEEESSSESERSRSESRESESESEEESSEESSEESRSSSSSSSESSEEEREERSSSSSEESSEESSSSEES
SSESEEESESREESSSESSSEESEEEESSESSEESSESESSSREEESSEEESEESSSESSESSSSEESSSRSSSSSSEEESRSEEEESEEESEERSEEEEEEESSSESEEEEESESESSESREEEESSEEESEESSERSSERSSSREESSEEERSESEESESSREEESSSSEESESEEESSESSESSSESSSEESSREEEESEEERSEESEESESSESSSEEEEESRRESESRRESERSEEEERERSEEEESSSSERESESEEEEEERSSSSSREEERSSEESESSSEEEEESEEEESEREEESEESSSEERSSESERSEESEEESEEESEEESSEESSEEESSEESESESRESSESEEEEEEREEESEEEEESEEEEEEESEREESSSSEEEEESREEE
ESSEEEEEEEESSSSESERREESSREESESSSSSSESSEEEESSESSEEEEESEEEEESSESSSEESESSREEESEESSESSERSSEEESSRSESSSSESSSRSEESSESESEEERSESRSEEEESSSEEERSSSEEESRESESRRSSSSRSEEESEEEEEESEESRSESSREESRESEEEEEESEEESSEEESSEEEESESEESEESSSSSESEESSEERSSESEESEESESRERESSSERRSSSESEESSEESSESSSSEESSEESESEEEEEESSSESSEESERESESEERSSEESSEESSSESEESESSEEEEEEESEEEEEEEEEEESSSSEEESRESSSSSESSSSSSSSESSESEREEESSEESEESSSEREEERSSREEEESESESSEESES
SSSESESESREEREERSESSSSSESEESESESSSESSESSSEESSSEEESSESEEEESRSSSESRESESSSEEESSSESSSSEERSSESEEEESEESSESSREEEERERSSSSESEESSSSEREEESSSSSSSRESEESERSSESSEESSSESRESRSESESEEEESESSSSSSRSSSEESEESEESSEEEESSEESERSEESESESSSSSEESSESSSEEEERSEESSSEEESSESSEESSSSSESEESEESSSSEESSSSSRESSERESSESSEEESESSESEESESESSEEEESEESSEERESEESSESSSEERRRRESREESRSSRSESSSESESEEESSSSESEEESEESEREEEEESSSESSERESEESEESESSSSEESSESEEESESSEEES
ESSSSSEEESSSSSSESESESSSEESSSSSSESEEEEEESSESSSESSEREESREESESRSSESESESESESSSSEESESSEESEESSEEEESESSSESSEESSEESEEEREEEEEESSEEEEEESSESSSSSESESESESSSESSESESSEESREEEEESSEESEEESESEREESESESEESEESESRESESEEESSESSESSSSEEEESSEESEEEEESSSESESESEESEEEEEESESESESEESSSESSSESEESSSESESSESESSESEESEEEESSSESSSSSEERERSEESEEESSESSSESSESREEEERESSRESSEEESSESSERSEESSEESSSESSSSEEESSEEESESEEESEERSESREEESSSRSSSSESSSSSESEESEESSES
SSSSESSSSESEEESSEESSEESESSSEEEEREESSSSEEEESEEREEESSSSSSSEEEESESSSEEEEESEESEEEEESEEESEESSSESSSSSEREEESSSESSSRSREEEEESSEESEEESEESSEEEEESSEEESESESSEERSSEESSSSSESSSSEESESSSESESSESRSSESEESEESSEEESESEERRESSSEEREESSSEEESSRSSESSSESSREESEEREEERSSSESESESSEEEEESSRSSRSEERSEEEEEESEEEESSESSSSESEEESSEEESEESEEEESSSSESRRESESEESERSSSSESSEEESESSRSSSEESSEESSEESEESEEESSSSERSEESEEEEESSEEEESESSESESSEEEEREESESSSESESESESE
EEEESSEEESRESSSESSSSESSEEEESESSSSESSSRESRSEEEESSSSSESEESESSSSSSSSSSSESEESESSSSSREESESSSESSEERESESEESRSSSSRESESSSSSSSSSESEESSSEESERESSESESESSSESSSESSEEESSSSERSSESESSSSEEESESSSEREEEEEESESESSSEESSESESEESSEESESSSEESEEEESRSSESSSESESSEEEEEESESSSEEEESSSESEESESREESSEESESESSESSEESESESREEESEESERESESESESEESSESESESSSEEEEESESSSERSSSSSSSSEEESSEESEEESSEEEESSSESSSSEESESSSESREEEEEEESSERSSESEEEESSSEEESSSEEEESSSESSE
EEEEESSSSESESRSSEESSSRESESSSEEEEEEEESSSESSESSEESSRSSSEEESESESSEEEESSERESSSESEREESSEESEEESSEESESESSESSESEESSERSSSEESSSSSSSSESSEESESSESSSSESESSSSSESSSSSESEEESSESEEESSEEESEEESSESSEEESSSSSSEEEESEEESSEESESERSSSSSSSSSSSSSEEERSRSSEESSSSEEESSEESSESRSSEEESSREEERESSSESESEEEESEEEEESESSSSEEESSSEEEEESSRSRESSSSESESESSSSSERSEEESSSESSRSESSSRSEEEEEESEESSESESSESERREESEEERESESEEESESESSEEESEESESEEEEESESSSEREEESEERSSE
ERESREEREEREESEEEESEEESSSSESESRSSESSEEERSSSSEESEEEESESESSRSSRREESRESEEESSEEESRSEESSSSSSEEEESSSSEEEEESESSSREESSEERSEESSSERESSREESEEEEESESSESEEESSESEEEERESEREESSSESEEESEESSEEERESREREESSESESSSESSSSSESSSEEEESSEESSSSEREEREERESSEESSRESESESSSERERSSESSSESSEESSSSESESSESSSEEESEESEERRSSESEEEESESSSSSSSSESERRERSSSESSSSRSERSSSEESRSSSSESSSEESSESEEEESRSSERESSESESESESEEESSEESEEEEESESEESESSEEEEESEEEESESSEEEEESSSSSS
SEEREESESSSSSEEEERSEREESEESRSSSESSSEESEEEESESERRSSSEESESSEESESEESSSSESESSESSERRSSSEESSSREEEEESSSESEEEERSESSEESEEEESESSESESSRSSSEESESESEEESSEEERESEESSSSSSSSSSEESSESEEESESESEERERSRSSSSESSESEESESSSEEESESSSEEEESSSEEESSSSESSSSSSSESSSESSSSSESSEEEEEESRESEESSEEESEEEESESESSSEESEESSSSERERSSSEEEEESSSSESSSESSSESEESSSSESSEESSEESESEESSSSRESSSSSESEESSSESSSSSSSESRSEEESSESRESSEERSEESSESSESEEESREESERESEESRSSSSESSSE
SREESEEESSSESREESEESSSSESSSSESEEEEESSSSEEEEESSSSERSEESSESSSESSSERSSSESESSSESSSSESESEEESEEEEERESRSEREEESESEEEEESESSSSSEEEESSESSEEEEEERSSSRESSEEESEESSSSRSESSSEESESRSSEEESSESEESSSSEEEEEEESESEEESESSREEESSSSSEEEESSERESRERSSEESESSEEERSESSESSSSSSSSEESESSSSSSSESEESESSEEEESSESERESSSESSRSSRSSSSESSSESSSESEEEESSEEEESESEESESSSSESSEESESEESSESSESESESEEEEERESESEEEESESSSESRSSESSEESERSEEESSSEERESSSRESESESEEESESEEES
ESSSSSSEESEESESEEESSSSSSSSESESSESEESESEEESEESSSSEEEEESSSSSSSSEESSESRSESSEESSSEEEESEEEERSEEEEESEESSESSSSEESEEEESSESSESEESSSESSSEESEEESERESESSEEESEEEESESEESESSSSESSSEESSSSSESEEEEESSSEEESSESEEEESSEESESEEESRERESEESSSSEEESSSEEEEESESSSESESERSESESEEREEESSSSEESEEESESSSEESESESEERSEEEESEESSSEESESSSEEESSEREREEESESESEERSESSSSREEESEEEEEEESSESEESSRRESSESSSESSSEEESEESESEESESSSSSREESSESEESSEERSESSSSESSEESEEESEESE
SSESSEEESSSEESRESSESESSRSSSSESEESSSSRSSSEESESEESEEESESSEESSSEESSSSESEESSRESESSSESRERSSSESERSSRRSRESESSSEESSEERSERSSSEEESSSSEEESSEESSSRSSEEESESESSSESRESEESSRRESESSESSSRESSSEEESRSEEESSSSESEEESSSSEESSSEEEEESESESSSSEEESESESSSEEESESSSESRSSESRSEEESSSSSEEESSSEESSSEREEEEEESSEESESSESESSSESSEEERSSEESREEESSSSEEEESESSREEEEEESEEEESSSESESSSSRSSEERSSESSSSSESSSSEEESSSESSERRESRSESEESSSSSSSSEEESESSESSESSSSESEESSRSS
SESESSEEEEERESSEESSSESSSSSESSSEESSESRSSESSSSSSSSSESSSEEEREERESSESSEESEEESSSSSSESESSESESESSSESEESSSESSSSRSSSSSREESSEESSSSSEEEEESSSESSSESSEEESRSESEEESESRRESRESSEEESEESESESEESSSEERSSSSEEEESSESESSESESEEESSSSRSSSRESESSESESSSSSSEESRSESSEEESSSEEERSEEEEESEERESSEESSSREESSEEEESESESESRSESSEEEESESSSSSEEESSSEESSSSSSSRSEESSSRSESSSSEESERSEEEEEEEEESSRESEEEEEEERESEEESESSSEESESRESSESESSSEEESSESEESESEESESSESEESREESS
SESESEESSRESSSESESSESRSESSSSERSSSESEESESSRSEREERESSESEEEEESSESSSESSESEEEESEEESSSSSSESSSEESEESSSSEEESSSSEEEEEESSSESSSSRESSEESSRESRESSEEESESERESSEESSSRSSSSESESSESESESESRSESSSESSSSESEESSSSSSESSSERSEEESESRSERSSEESSSESSSEEEESEEEEREESSESSESSSERREEERESSEERESERSSSESESSSREESSRESESSSESESSESSESEESSSSSSSSESRSSRSESSEEEESESSSSSEEEESESSSESRSSSESESSESESESSSSSRSEEEESSSSEEESSEESSEEEEEERSRSSESESSESSSESSEEESSESSSSESS
SSSEEESESESESSSRSSSSSREESSSEESSRSSSSSESESSSSSRSSSSEEEEEEEEESSSSSSSRSESSSSSSSSSSESEESEEEESSERESSSSSEESSSSEESSEEESSESSEEESEESSEESEESESSSSSSSSSSEESESEESSREEEESSSSSSSESSSRSSREERSEERSSSSEEESESSESSEESESEESRESSSEESSEERREEEESSESSESRESSSSSSSEEESEESESSSESSSSSEESSESSSSSSSESSSEEEEEESESSSSEESSSSESESSSESSSRESSSESESSESESESRSSSSSEEESSSRSSEESSSSSSSRESSESRSSESEESSRSSSESESESEESREESESSSSESRESSEESSSSSSSSSSEEESSSSSESSS
ESSESSESESSREESSEESSEERESSEESSSSESEESSSESSSESEEEESEESSSSESEEESSESESSSEEESSSSESSRESSRESSSSRESSSRSESSESEESEESSESSRSSSESSSEESESREEESSSSESSSESSEEEESESSSEERSSSSSSSEESEESESSESSESEESEEERSSEEESSSSSESSSRSSEEESESESSSERSESSSSESSSSESSEESSSSSSESESSESSSEESSRESSEEERSSEEESSESSSSSESESSESEESEESSSESSEEESSSEEESSSSSEESESESSESSSRSESSSSSSSESRSSRRSSSSESESSSSSESESSESERSERSRERSEEEESSEEEEESSEEESSSSESSSSSSSSRESSSEESSEESEEEES
SSSSSSEEESESSSSSESSSERSSESSSSESSSSSERSESSSSESSSRSSEESSEREESESSEESSSSSSESSREESEESSESSESSESSSSEESESSESEESEESSSEESSRRSEEESSSSSSESRESEEESSSEESSSEESESESEEESEEESSRSEESSEESSESRSEESSEEESSSSRSEESSSESERSSSRESESEESREERSSEEESSESRSESSESSESEESSEEEESESRSSSEEEERRESSRSSEEESESSEEEEEEESSESSERSESESERSSESSSESSEESSRSSEREESSSEESESSESSEESESRSSSSSSSSSSRSEEEESESESESESSSEREESEEEESESEESESRSSSSSSSERESESREESSESEESESSSSESSEEESE
EESERSSSEEESESRSSSSREERRSSSSRSESRRESESESESREEEESSEESSSSESEEEEESSEEESESESSEEESSESSEESSSERESSSSSSEERSSSSEEESESSESSSEESSERESSSERSEERSSSSESSSSEEESSESEEEEESSSSSSSEESSESSESSSESESSEEEEEESSSSESEESSSEESSSSEEEESSESEESSESSERSSSSESSRSEEEESESSESEERSSESEEESSSEESERSSSESSSSSSESSEESEESEEEERSSEESESSSSESESSSSEEERESEESSSSSSSESESERSRSESSSSSREEERESSEEESERSSSSESSSEERESSSSSSSEESSSESSSSSESSERSESESESSSESSSSSSSSRSSSSSEEEEES
EESESREEERSSESERSSSSEEESESSSEESSSSSSERESEEESSESESESEESERESSESSSESEESSSERSSESSESSESSSEERERSRRESSSSSSESSSRSESESSEERESRRSESSSSESSRERERERSEEEESESESEESSEEESSEEEESRSSSRSSRESSESSSEEEEESESSERREESSSSSSSEESESSSERERSEEESSSSSSSSSSESSERSESSRSSESESEESESSEESESESRSSSERSSSSSSSSREEESSESESEEERSSSESSSREESSESSEESSESSSSSSSSSESRESSRESSSESESESSESEEESESRSEESSESSSESESRSEEEESESEEESSERSSESSRESERSESSSSSSSSSSSEEESESESRESESSSSR
SESEESEERSSSSSEERERSSSSSSSSSSSESEESSESSRSSREEREESSSSSSSSSSSSEESEESSSESESEESSSSESSSSSESSESSSSEEESSSRSSEEESSSSSESESESSSESSSSSSEESESSEESSSESSSSSERESESSSRSESSSSSSSSEESSESSSSESSSERSSRSSEESSSSESSRSEESEEESSSSESSERSESSSEEESSESSSRESEEESSESSSRERSRESSESSSESSESSSSESSSSRESESSSESSRSEESEEEEEEESSSSSSSEEESSSESSSRSEEEESRSSSESEEESSEESESSESRSSESSSREEEERSSSESSSESESSSSSRSEESESSSSSESSESSRSEEESSRSSSSERESSSSSSSSSREESSEESR
