                                                                                                                                                                                *|*  *|*                                            *|****     ***                                        *|*|*                              *|*          *|*                           *|*                                     
                                                                                                                                                                                *|*  *|*                                            *|**|*     *|*                                        *|*|*                 ***          *|*          *|* ***      ***              *|*                        ***          
                                                                                                                                                                                *|*  *|*                                            *|**|*     *|*                                        *|*|*                 *|***        *|*          *|* *|*    ***|*              *|*                        *|*          
                                                                                                                                                                                *|*  *|*                                     ****** *|**|*     *|*          ***   ***                     *|*|*                 *|*|*        *|*          *|* *|*    *|*|*              *|*                        *|*          
                                                                                                                                                                                 |    |                                      *|**|*  | *|*      |           *|*   *|*                     *|*|                   |*|*         |            |  *|*    *|*|*               |                         *|*          
                                                                                                                                                                                 |    |                                      *|**|*  | *|*      |           *|*   *|*                      | |                   |*|*         |            |   |     *|*|                |                          |           
                                                                                                                                                                               - -  - -  --  - -  -  --   --    -    - -   -  |--| - -  |       --  --    -  | -- -|         --  -  -     -| - -   -  -   - --  ---| - - --  -- - -- -     -   |- - --| |  -   - -  - -- -        -    -- -  -      |- -   -   -
                                                                                     ***                                            ***                                     -- E-S--E E- EE  S-S- E -SE   SE- --R-- -S E---E--|SS| E-S--|- -- --EE -SS--- S--| SE-S|     -- -EE  E- S -   E- S-S- -S- S - E-SE- ESS|-E E-EE -SR R-EE-E---  E- --E S-ES|----S---E E--S-SE-E- ----- E--  SS-E  E-------S-R- -S---E
                                                                                     *|*                                            *|*                                     ES-EESEEE-EE-SE--ERSE-E-ESR---SEE-ESSES-SE-EESSEES-SS--SEEEE-S-EE-ESEE-EESEEE-ESS--ESRS------EE-EES--EE-E-S---SS-SESS-EEE-E-E-SSEEE-SSE-SS-SEEE-EEE-ESSSESSES--ES-SES-EEEE-ESSESEESR-SSESSEEEEE-EEESE-EEE--EEEE--EEESESEEESRS-ESEESE
                                                                                     *|* ***                                        *|*                                    -SSESEEERSEEESEESSSEEEESEERERSREEEEERSEEEEESEESERRSREESSSSRSSEESEEEEEESESSEEESSSSEESRESSESEEESESEESEESESSESEESESREEESESSSEEERESREEEEESEEEEEESESSSSESSESSSESEEESSEESEEREREEEESEESSSSESSESESSEESSEESESESSESSSSEEESEEEEEEESEEEREESESEESS
                                                                                     *|* *|*                                        *|*                               -  --ESESEESEEEESEESSRESEESSEESSESEEEEREEESESESSSSEESEESEESERRRSESEESEESSEESEREEEEESESESEEEESSEESSSSESSESEEESSRSEESESESESEEEEEEEEEESSESESSESSSSEEEESESEEESSSESSEESREESSSESEESESEREESREESSSRSSSSEEEEEESEESSSESSEEEEEEEESSESSSESESESEEEEEERS
                                                                                     *|* *|*                                        *|*                            - -S--SSSEEESESSSESRRREEESSEESSSEEEEESSSRESEEEEESSEEEESSSSSEESESESSSEESSEEERESSSSRESESRSSSERSSESSESSEREEEERERSSSSSSSSSEEESESEEEEESEEEREESSSEEEESSESREEESRESESEESEESESSSSEESESESRESEESEESESSEESESSEESESSESESSRSSSSEEEESSSEESEESRSEESESSSESEEEE
                                                                                     *|* *|*    -          ***                      *|*                          --E-SESSEEESSESEEEEEESSSEEEEEREEEEESRERSEEEEESESEESREEEERSSEESSSEREEEEESEESSEEEESSSESEEEEESERSEESSSEESEEEEESESESESSRSSEESSEESSREERESEEEESSSSEEEESEESSSRESEESEEEESSSEEESESEEEEESSESESSEESESESESEEESSESERESSESEEESEESESESSSESSRESSSSSRSSSESESEESR
                                   ***                                                |  *|*  --S-         *|*     *** ***           |                  ---------SSEEEESEESRERSSEEESEESSSEEERSEESEESEEEESEEESSSSEESREESESESSERSSEEEESEESEESEEEEEEEEESEEESSSEEEESSSESSESSESRREEESSSESEEEEEESSSSESEEESEEEESEEEESSSSSSEEEESESEEEEESEESSEEEEEEEESSSSSSEESEESEESESRSEEESSEEEESESESRESSESSSEEEEEESSEEESEESESESEERSSEES
               ***                 *|*  ***                                          -|   | --ESES-        *|*     *|* *|*           |                --SSSEREESESSEESSSEEEEESSRSSEEEESSRSESSESEEEEEEESEEESSESEESEESEESEESEEEEEESSEESSEESSESSESESESSSSESEEEESSESESEREEESEEEEESEEREESSESESSSESEERSRSSESEEESESSEESRESESEEESEREEEEEESSEESSSEEREEEESSSSEESEEESEEESSEEEEESEEEEEERESESEEEESEEESSESSSESSSEEEEEEEESEEEEE
               *|*                 *|*  *|*     ***                  ---   -        -E-   |-ESEESES-       *|*     *|* *|*        -  --              -ESESSESEESSSEEEESESEEEESEEEEESEEEEEESEESERSSESSESSSEESSEESEREEERSSEEEESRSSSEEEEESSEERESEEESESSESSESESRSSSSERSSRESSEESRSSSESSESESSESSEEEEEESREEESERSESESSESSESSEEESESSEEESSSESEEEEERESSREESEEEEEEESEEEEESRSESSSSEESSSEESESSESSSSEEEEEERESESESSSEEEEEESESESE
               *|*                 *|*  *|*     *|*                 -SES---E--------EEE----SSESEEESS--     *|*     *|* *|*       -E--ES---      -----SEEESEEEEEEESSESESEEESEESSESSSSSEEESRSEESEESSSSSSEERESSSEESSSESSSESEESRSEEEEERSERSSEERSESEESRSEEESSEEESESEEEEEEEEESESESEEEERSSSESSESSSSEEESERESSSESESSEESREEESEESESEEEEESSEESEESEESSSESEEEESESEEESSERESEESSRESESESESERSSESESSSEEESEEEESESSSEEESSSRSSEEEESSS
                |                  *|*  *|*     *|*       -        -SEESSEEEEEEEESEEERSEEESEEEEEREESES---   |      *|* *|*      -EEEEESREE------SESESEEESSSESRSSESSSEEESEEEESEEESEEESSEESSEESSSSSSSSEREESESEEESEEEESEEESEERSSEESEEESESESEEEERESSRSSESSEERSSESSEEEEEEESESSEESESESSESEEEESSRSESSSEESESEEESEEEEESSESEEESSESEEEEEESSEEREEEESSSEESRSSSESSESEEREESSSSESEEEESSESSEESSSEESESSSSESESSESSESESEEEEESEEESSEE
        -       |                  *|*  *|*     *|*      -R--------SSSESSSSSEEERSESESESSEEESSESSSESSEEESE---|       |   |      -ESSEEEEESESRREESSSSSEEEEEESEEESSSEESRSEEESSEESSSSSESEEEEEEEEESEERREESSSESSSSEESSEESESESEESSSRESSSESSEESEERERSESSRSSSSESSSESEEEERSEEEEESRESSEREEEESSSRESEESRERREESSSREEEEEESSEEEERSSESESESSEESESEESEESSSSSSESESSSREEEEEREEEERSESEEEESSSSSEEESRERSSSSSSSESSESSESSESEEEEEEEESEESEES
  ------S---  -----                 |   *|*     *|* -- --EESSSSSEEESEEEEESEEERESESEESEEEEEEEEESESSESEESERESS-      -|   |  ----EEEESEESEEESESEESEESSEEEEEESSEESESSSSRSEEESEEEESSSESEESSSESERSEEESSESSESEEESSEESESERESSEEEESSSSEEEESSEEESSSEEEESEESESREEEEEEEESEEESSSSSEESERESSSSEEESSSESSSREESESESEEEEEEEEEEEEEESSEEEEEESSRSSSREEEESSSEEESEEEERESSESESSRSSESSESSERSSRESRSEEEESEEESSSRESSEESSSSSEEEEESSESSSESEEEE
 -SSSESREESE--EESSS-         -      |--  |       | -SS-SEESESERSEEEESSESSSSSSEESSSESSSESEEEESEESESESSEEEEESEE--   -E- -----SRSEEESSRESEEEEESSESEERREESESREERSSESSSSSSEESREESESESEESSSEEESSSESSESSEESSSEESSSESSESESEESEEEEEESESRESSESSESEESSESSSSSRSSEREESSESSEESEEESESSSSSRSEESEESEESRESSEEESESSESEESESREEEEESSSSSESSEERSEEEESSEEESSEEEEEEESESSSESRESSSEEEEESSERSEESSSESRSESEESERSSEEEESSEESESEESEESEEEEEEESEESR
-SEEEESESSEESESESSEE-   --- -E----- -ES--|       |-EEESSSSESSRSSESEEEERSEEESSESSEESSEESESSSEEEEEERSEREERESESEEE---SEE-EEEESEESSSSSEESSESSSESEEEESSESEESRREREESEESSESSSSEERESSESEESSSSSSEEEEEEEESSEEESREESSESSEEESEEESESEESESESSERSSEEEESRSSSSESREEESSSSEESEEEESSSSSSESSEREESSSSEEEESRESSESSSSESESSERSREERSSSREESESSESEEEEEEESSEESEEESEREESSSEESEEESSESEEERSRSSSESSSEEEEESSESEESSEEESESESESEERRESESEEEEESSESSSEEE
SEEESEEESSESSSERESRSE---SSE-SSSSSSS-ESESE--- --- -EESESRSSSSSSESESEEESSESSESSESEESEEEESSSEESSERESSESSSESSSSEESSSSSESSESSRSSSRSSSESESEESESSSESSSSSSSESSESESSESSESSESSSSSSSSEESSRSESESSRREEESSESEESEESEESESSSSRSREESEESEEEESSSEEESRESEREEESESESESESSSSRSEESESRSESSSESEEEERESSSEEESESSEESSSSSSEESSESSSEEEESESESSEEERSESSSEESEEESSRESEEESSRESEEEESEESSSEESSEESEESESESEESSEESSEEEESESSEESSSSSSSESSSSEERESSEEESRSSEESE
ESSESSRSSSSESEESSSSESSESESEEESSESSSSSESESESS-EES-SSSESSSESESESSSEESEEEESEESSSSERRSSERESSSSESRRREESSESSEEEEESESESSESEEESSSSSSESSSEEEESESSSEESEERSSEEEESSSSSESSSSESERESEESESESSEEERESESESSSESESREESSEEEESSSESSSSSSSSEEESSEEESSSEEESSESEEESEESEESESEESESSESREESEESEEESESEEESEESSSEESEESESSEEEESESEEEESSERSSSEEESSSSEESESESEREEEESSERSESEEESSEEEESSEEESSSEESSRESSSSRSSEEESSSSEREEESSEEEESSESSSESEEEEEEEEESSEEEESSSSS
ESESESEESSESESESESESSSESSSESSRSEEESSSSSSEESSSEESEESSSESEEESESSEERSSESSSSEEESSRESSSSEESSRSRRESSSEEEEESSESSESEERSSEEESESEEEEEEEESESEEEEEESSSSRSSRSEESSSESSSSESESESSESSESEESEEESSERSSSSESRSERSEEEEESSSSSEESSESEEEERESEEEEEEESSESSSESEESSREERSESSESSESESESEEERSRREESESSSSSSSEEEESSSERESSESESSEESSSESESEESESEESSERSSSESEEEESESSRSESEEESESESSSSESEESRSESSESEEEREEERESSSESEESEREESEESSEEEESEESESESSRSSSSEEESRRSESESREES
ERSESERSESEERSESSESEESSSEEEEEESESSEREESRRSERESEESSSSESESESSSESESESREEESSSSSEESESSREEESSSSESEERSESESSSSEESSESSSEEESEEESSESSESESERSSEESSSSSESEREEEEEEESSESSEEEESSSESESESESSEEESSEEEESSSESSSSEESSSSSESRESEESSESEESESEEERRSEEESSEEEESESEEEEEEEEESSSSESESESSESERESSESEESREEEEESSEEESSESESSSRSESSEEEEESESESSEEEERSEESEEESSSEEESSESSSSESEEEEEEEEEERRSEREESEEESESEEESSSSEESSSREEESSREEEEESESEEESEESSSSSSSSESSEESESSERESS
EEESERSSSEESSSSESERSEESERESEESSEEEEESEESSSESSESEEESSESSSESSSEEEESSSSESESEEESSSEEEERESSEESSSEEEESSEERRESESEEEESRSSSSRSSEESSESSSEESEESESEESEEESEEEEESSEEESESESESSESSESSEESEEESSEESSSRSESESERSEESESSSEERESSEESESSSSRSSEESEEEEESERRSSSSEERSESSSESSSESESSEESEEEESSESRREESSSSRESSEESSSREESSEEEEREEEESSSSRESSEESEEEESSEESSESSSESSSSSESEESSSEEESEESESSSESSESSESESESSRREESEEESSEEESSSEESEEREESSSSESESERESESESSESESSSESSEE
SSEESEEEESEESEESESSSESSSESESSSSESEERESSSESEESSREESEESESSSSESSSSEREESSSESSSESESESSSESESESEEEESEESSSSSSEEESESESSSESESEEEEEEESSSESEESEEEESSRSESESEEESEESSEESSEEESESSEEESESSEESREEESSSSEESEEEERREESSRESEESESSESEEEERESSSEEEESREEEEEEESRREEEESSEESERSSSESRSSSSESEESSEEEESRERSSSSSEESSESSESEESSEERREEEEEESEEESSESSREEESSESESEEEESSESSESSSSSSEESEESSSESRESSESESEESESSSEESEREEESSSESSSSSSEEESEESSRESEESSRSRSEESESEESEEES
ESSSSEEEEESSEEESESEEEESSSSREESSESSREERSRSESESSSEESRSSSERESEEESSSSSESSEEEESESSSEESEESESSRESEEEEEESSSEEESEESEEESSSESSSESEERESSSSERSESSSSSSEEEEESESESESSSSERSSSESEREREESESSESEEEEESRSSEESEEEEERSSSEESESSEEEEESEESSSEEEEEEEEESESESSESSEESSSEREEEESESSRESESSESESRSEESSEEEESRSSSSESESSSEESEESESSEEERRSEREEEESSSESESERSSSEEESSSESESESSSRESSSSSERESEESSSSSSSSEESRSSESRSSSEESSSSSESEESRSEESSEESEEESESSERSREEEESEESSERSSSS
ESESEEEESSESSEESESESSESESSSSESEESEESEESSSSSSSESEEESEEREESESSSSERESESEESEEESSESSEESSEEESSEESEEESESSSSSEEEEESSSSEEESREEERSESSERESSESESESSSSESESSSREEESEESSESESSSESSSSSEESRSESESEEESSRESSESSSSSSSESSSSESESEEEESSERESSSESSEESSSEEREESSESEESSESESESESSSESESEESEERSSESSESSESSESSEEESRSSSSEESRESESSSSERSSESEESESSSESEESSRESSESEEESSSSSESSESSESSSESSESRSRSESSRREEESESSESEESSSERSEEESSSSSSSSESSSSSREESESESEESSSESSREESSSE
ESSSSRSSSESSESSSEESSEESSRSSESEERSEEEEESESESEEEEESSSESSERSSSSEESESSSESESSEESESERSSESSSSESSSSESSSESEEESSSESSESSESEESREEESSESSEEESEEESSEESSREESSSEEREEEESSSESESSSESESSEEEEEESESESEESEESSRSSSEEESEEESEESSSESSSSSESSSSSEREESEEESERSSRESRSEESESESERESESSSSSESESEEESSEESEESEEERSSEESSSSEEEEEESSRSEESEEEESSESSSESSREESSESEEEESSEEESSSEREEEESRSEEEESSSSESEEESRSESSSSEEESEESERESESSSESSSSSESESESEESSESSEREESRESESSESEESSSR
SESSESESESEESEREESESSESESRESSSSSSSESRSEEERSSSEEESSESESRESSSESEESSEESSSSESSSESSESRSSEEEERERSSSESSESSSEESSESEEESSSSERSRSSESSSSEEESSEERERSSSESSSSEEESSSSESSSESSSRERSEEEESSEESESESESSEESEESESSSSSRSSESESEEESSEESSSSRESSSSSEERERREEEEESRREEESESRSSSSESRSSEEESSEESESESSEESESESESSSSESESSERESSSSEEESEESSESESRESEESSESSEESRSEEEESEESSSEEEEESSESSEESSSSSESSSESSSSEEEEESESSSSSSSSSSSSSSSRESEEEREESSESSSEESEERSSSSSESSSSESS
SSESEESSRSEESSSEESEESSSERSSSSERSSREESSESSEERSESEEESRSSSESEEESEESERESESEEESSESESESSSERSSSSEESSESSESSSSEEESESESSSEESSRSESSSEEESERESSESSSEESSSSERESSSEESESSEEREEEESEESEEEEESESSESEESESEERERESEESSSSSSRESESEEESEESESSRSEESSRREESSEEEESESSSEEREESRESSSSESSEESSEEESEESESSSSSSSSRESSEEERSSSREESEREESSESSEESEESSEEERSSRESSSSEESESRRSSSESEEEESSEESSSEESESSESSSESSSSSSSSSEESSSSSRRSERSSSSSERERSESESSSSESEEESSSSSEESRERESSE
EESSESSEEEESESESESESSESSSESRSSSSRESSESSESEERSESESEEESSSESSSSSESEESSEEEEESSESESSSSSESEREEESEESEESERSEERESERSERSESESRSSSSEESSESSESSSSEEESEESSSSSESSSSSSESESEESSEEEEESEEESESESSSSSSEESESSSSSESESSESEESEESSESSSSESSRSSSSSESEEEESEESRSSEEESESEEESSESSSRSSESSSSESESESREEESSSSRSSSSSSSSRSSSESSSSESSSRSSREESSSESSSSSEESSESSESEEEESESESEESEERERRSSSSSSSSESESESSEEESSSSRSERSSSRESESSSERESSSRSEEEEEESESEESSSSEREESESREERESS
SSSSSSEESSSSESSESESSSSSSSSESSEEESSSSSSSESSRSESSSSESSSSSRSSSERESESSSEESSSSEESESSEESEEESESEESSSSSEEEESSSEEEESESSSESEESSSSSESESESEESSSESEESEESSSSSESSSSESESESSSSSESESSSSESSERESSEESREEESSSSESSSSESESSEESSSEEREESESSSESSSESSSSSESEEESSESESESESSSSSRSSSSEEEESSEESSSEEESESSSESREEESSSRESSSSSERESSRRESSRSSSSSSESSSEESESSEEESESESSSESSEESEESSSESSRSESESESESEEEESEESSESESSSSSESSSSSSRSSEESEESESSSSSRERSSSRSSSSRSSSSERSESS
SESRSERESREEERESESSESSSSSSSEESEESSSEESSSEEESRSEEERSSEESSSREESESESEESESSSSSESSESRSSSSEEESESSSESEEESRSSEESSRRSSSEEERSEESESSSEESSSESEEESEESSEEEESSSSSSSEESEESSSSESSSSEEEEESSSERRSESSSSSSESSSSSSEEESESERSSSSESSSESESESSSEEESSSESEESSEESSSSRSSSSSSSSSESSSSSESEEEEESSREEEEERESSESEESEESSSSSSSSSSSEESESEESESSSSSSSSESEESSSSSEEESSSRESSSERESEESSEESREEEEEESERSSSSRSEESSRSESEESEEEEEESSESSSESSSSSSESSEESESSEREEESSSSSSSSE
RSRRESESSEESRESSEERSSSESEEESRESERSSRSSESSESSRESSESSSSSSSEESSESSSESSSSSESRESESESESEESSSSESSSESEESESSRSSEERSSSEEESEESSRSEESSSSSSSEESEESSEERESSEESSEESESESSSRSERREESSSSSSSSSERSSESSSSERSSESEEERSRESEERESSESERSSSSESESEESESEESERSSRSESSSSSSEERESSESEEEEEEEERSSSRRRSSSEEESEEEERESESRSESERSSEEESEREEESSEERESSEERESSEEESSSESSRSEESSESEESRSRRSSSEEESESESEEESEEERESEESESEEEEESRRSSEESREESSEEEEEEREERSESESSESSESSRESSSESSS
SEESSEEESSEESSSSERSSREEEESSEEEESEEEESSSSSEESESSEESERSEEESEESSSSSSSSEEESESESESEEEESSSERSSSESSSSSSSREEEEEEESSSEESSESSSERSSESSSSSRSSRSESSSESSSSSSSSSESESRSRESSEEESESEESSEESSREESEESSSSESESSSSESESSSRSSESESREESESRSEEERESSSSSSSESSRREEEESEEEESSSSESSSSSESRESSSSSSSRSSESSRESESSSESESSSSEEESSSEERESSSERESSSSEESSSESSSSSSEERSEESSERESSSESSEESSESSESEESSSRSESSSSSSSESEESSSSSSSSESSEEESSRSESESSSESSSSSEEEESEEESEESSSESSSE
ESSSESESSSSESSSSSSSSSEESSSSESSSEESSSESESSSEESSSSESSSSSEESSSSSESSESRSESRSESESESERSRRESESSSSSSESESSESRSESSESRSESESESSESESEESEERESSSEESESESSRESRSEERSESESSSRSSEESSESESESEREREESSSSESEESSRSESEESESSSSSSESEEEREESEESESESEEESSSSSSSRSESESSSSSSSSSRSSSSSESRESESEEESRSEESSESSSEESSESESSSRSSESEEESSEEESREESSESSEESSEEESSESSESSESSESSSRSESSSSESSSSESSSEESSSSEEESSSRSSESSEESSSSSSSSESSSSSSESESESESSESESSESESSESSSEESESSESEE
ESERSSSESSSSSSSESERESSESSESERESSSESEEESSRSSRSRESRRESSSSESSRESSSREERSSSESSSSESERSSESSSEESSSESSESSRSSSEESSSSSEEEESSRSSESESESESSSSSSSSEEESSESSESSERSSESSSSSEESERESESSSRSSSESEEESSSSESSEEEESSSRSSEERSSRESSRSSESESESEERREESSEESESSSSESEEESSSSSESSEESSSESEESRRSESSSSSSSRSSESSSSSESEESSERESSSSEERSSSSSSSEEEESSSRSSSSSESSRESSSSRERSEESSSESSRESRSESESSSSEESSSSSEESRSSSREERSSESSRSESEEEESESSESSSSSSEESSSESESSESSSESSSESSRS
RSSRSSSSSSESESRSSSSSSSESSSSSEERSSESSSSSEESEESRSSSSEEESSSEESESSSSSSSSSSSSSSSSRSSSSERSSSSSSESEEEREEESSSSSSEEEESEESESSSSRESSSERESSERSSSEESESERSSSEEESESSSERSSESSERESEESSSESSEESSEEESEEESESESESESESEESSESEEESESESRSSSESSESEEREESSSSRRSESSSSESSSEEESSREEESSSERSEESSSSSSSEESEESSSSSSESSRSEEERSESRSSSESERESSESSRESSEESESSEEESSSSSESSEEEEEESSSESESSSRESSRRSSSESEEEESSESSESSSSSESSEESRESERESSSRSSSEESSSSSESSEESSSSSEERSSE
